Time,Line,Unknown,Female,Male,Total,old_line
AM,BA10,0,67,92,159,BA10
MD,BA10,0,144,58,202,BA10
MD,BA10,0,133,61,194,BA10
AM,BA11,0,48,47,95,BA11
AM,BA11,0,34,78,112,BA11
MD,BA11,0,257,103,360,BA11
MD,BA11,0,255,216,471,BA11
AM,BA12,0,29,20,49,BA12
MD,BA12,0,24,0,24,BA12
AM,BA13,0,34,0,34,BA13
MD,BA13,0,37,57,94,BA13
AM,BA14,0,48,0,48,BA14
MD,BA14,0,45,20,65,BA14
MD,BA14,0,84,54,138,BA14
AM,BA15,0,47,54,101,BA15
MD,BA15,0,54,0,54,BA15
MD,BA15,0,0,40,40,BA15
AM,BA16,0,0,25,25,BA16
AM,BA16,0,34,67,101,BA16
MD,BA16,0,20,25,45,BA16
MD,BA16,0,108,34,142,BA16
AM,BA18,0,0,25,25,BA18
AM,BA18,0,47,47,94,BA18
MD,BA18,0,0,12,12,BA18
MD,BA18,0,97,25,122,BA18
AM,BA20,0,0,34,34,BA20
AM,BA20,0,34,34,68,BA20
MD,BA20,0,54,24,78,BA20
MD,BA20,0,306,103,409,BA20
AM,BA22,0,43,0,43,BA22
MD,BA22,0,37,0,37,BA22
AM,BA24,0,57,20,77,BA24
AM,BA24,0,25,0,25,BA24
MD,BA24,0,43,0,43,BA24
MD,BA24,0,14,0,14,BA24
AM,BA28,0,0,47,47,BA28
MD,BA28,0,20,34,54,BA28
MD,BA28,0,0,28,28,BA28
AM,BA30,0,169,57,226,BA30
AM,BA30,0,25,0,25,BA30
MD,BA30,0,43,78,121,BA30
MD,BA30,0,260,89,349,BA30
AM,BA31,0,34,103,137,BA31
AM,BA31,0,0,57,57,BA31
MD,BA31,0,54,24,78,BA31
MD,BA31,0,74,140,214,BA31
AM,BA32,0,23,0,23,BA32
MD,BA32,0,24,0,24,BA32
AM,BA33,0,23,0,23,BA33
AM,BA33,0,47,0,47,BA33
MD,BA33,0,90,54,144,BA33
AM,BA34,0,54,124,178,BA34
AM,BA34,0,34,0,34,BA34
MD,BA34,0,92,34,126,BA34
MD,BA34,0,98,20,118,BA34
AM,BA39,0,23,34,57,BA39
MD,BA39,0,34,45,79,BA39
MD,BA39,0,165,12,177,BA39
AM,BA41,0,57,34,91,BA41
AM,BA41,0,0,49,49,BA41
MD,BA41,0,34,25,59,BA41
MD,BA41,0,78,68,146,BA41
AM,BA97,0,0,68,68,BA97
MD,BA97,0,0,57,57,BA97
AM,BA98,0,34,34,68,BA98
AM,BR01,0,374,382,756,BR01
AM,BR01,0,227,86,313,BR01
AM,BR01,0,0,45,45,BR01
MD,BR01,0,0,23,23,BR01
MD,BR01,0,303,175,478,BR01
MD,BR01,0,476,367,843,BR01
AM,BR02,0,447,167,614,BR02
AM,BR02,0,99,74,173,BR02
MD,BR02,0,22,0,22,BR02
MD,BR02,0,47,28,75,BR02
MD,BR02,0,181,17,198,BR02
MD,BR02,0,226,262,488,BR02
AM,BR03,0,185,177,362,BR03
AM,BR03,0,101,0,101,BR03
AM,BR03,0,0,28,28,BR03
AM,BR03,0,29,0,29,BR03
MD,BR03,0,43,0,43,BR03
MD,BR03,0,131,140,271,BR03
MD,BR03,0,301,308,609,BR03
AM,BR04,0,676,452,1128,BR04
AM,BR04,0,90,91,181,BR04
AM,BR04,0,0,27,27,BR04
AM,BR04,0,0,27,27,BR04
MD,BR04,0,28,61,89,BR04
MD,BR04,0,186,28,214,BR04
MD,BR04,0,602,332,934,BR04
AM,BR05,0,766,476,1242,BR05
AM,BR05,0,114,150,264,BR05
AM,BR05,0,0,23,23,BR05
MD,BR05,0,41,29,70,BR05
MD,BR05,0,296,134,430,BR05
MD,BR05,0,496,292,788,BR05
AM,BR07,0,419,390,809,BR07
AM,BR07,0,147,79,226,BR07
AM,BR07,0,78,0,78,BR07
AM,BR07,0,29,0,29,BR07
AM,BR07,0,28,0,28,BR07
MD,BR07,0,22,0,22,BR07
MD,BR07,0,88,28,116,BR07
MD,BR07,0,232,73,305,BR07
MD,BR07,0,386,270,656,BR07
AM,BR08,0,245,172,417,BR08
AM,BR08,0,23,0,23,BR08
MD,BR08,0,29,0,29,BR08
MD,BR08,0,34,28,62,BR08
MD,BR08,0,244,46,290,BR08
AM,BR09,0,197,146,343,BR09
AM,BR09,0,22,31,53,BR09
MD,BR09,0,55,0,55,BR09
MD,BR09,0,74,23,97,BR09
MD,BR09,0,274,124,398,BR09
AM,BR10,0,67,0,67,BR10
AM,BR10,0,0,25,25,BR10
AM,BR10,0,68,0,68,BR10
MD,BR10,0,26,0,26,BR10
AM,BR101,0,21,0,21,BR101
AM,BR101,0,23,28,51,BR101
AM,BR101,0,22,30,52,BR101
MD,BR101,0,23,0,23,BR101
MD,BR101,0,0,21,21,BR101
MD,BR101,0,52,23,75,BR101
AM,BR11,0,302,383,685,BR11
AM,BR11,0,1017,716,1733,BR11
AM,BR11,0,133,55,188,BR11
AM,BR11,0,23,0,23,BR11
AM,BR11,0,28,0,28,BR11
MD,BR11,0,60,19,79,BR11
MD,BR11,0,88,46,134,BR11
MD,BR11,0,571,408,979,BR11
MD,BR11,0,530,427,957,BR11
AM,BR12,0,122,21,143,BR12
AM,BR12,0,23,0,23,BR12
MD,BR12,0,23,0,23,BR12
MD,BR12,0,0,23,23,BR12
MD,BR12,0,161,44,205,BR12
AM,BR13,0,0,22,22,BR13
MD,BR13,0,22,0,22,BR13
MD,BR13,0,27,27,54,BR13
AM,BR14,0,331,286,617,BR14
AM,BR14,0,96,72,168,BR14
AM,BR14,0,0,68,68,BR14
MD,BR14,0,23,31,54,BR14
MD,BR14,0,49,59,108,BR14
MD,BR14,0,303,278,581,BR14
AM,BR15,0,499,335,834,BR15
AM,BR15,0,202,159,361,BR15
AM,BR15,0,73,0,73,BR15
AM,BR15,0,0,28,28,BR15
MD,BR15,0,59,28,87,BR15
MD,BR15,0,202,101,303,BR15
MD,BR15,0,377,249,626,BR15
AM,BR16,0,49,21,70,BR16
AM,BR16,0,28,27,55,BR16
AM,BR16,0,24,0,24,BR16
MD,BR16,0,59,24,83,BR16
MD,BR16,0,125,50,175,BR16
AM,BR17,0,122,94,216,BR17
MD,BR17,0,27,45,72,BR17
MD,BR17,0,22,50,72,BR17
MD,BR17,0,80,17,97,BR17
AM,BR18,0,416,304,720,BR18
AM,BR18,0,205,95,300,BR18
AM,BR18,0,44,0,44,BR18
AM,BR18,0,22,0,22,BR18
AM,BR18,0,23,0,23,BR18
MD,BR18,0,43,18,61,BR18
MD,BR18,0,27,91,118,BR18
MD,BR18,0,240,59,299,BR18
MD,BR18,0,471,278,749,BR18
AM,BR19,0,85,84,169,BR19
AM,BR19,0,40,0,40,BR19
MD,BR19,0,0,27,27,BR19
MD,BR19,0,19,0,19,BR19
MD,BR19,0,24,31,55,BR19
MD,BR19,0,103,47,150,BR19
MD,BR20,0,0,19,19,BR20
MD,BR20,0,23,0,23,BR20
AM,BR21,0,23,25,48,BR21
AM,BR21,0,24,64,88,BR21
MD,BR21,0,0,74,74,BR21
AM,BR22,0,22,0,22,BR22
MD,BR22,0,22,0,22,BR22
AM,BR23,0,387,273,660,BR23
AM,BR23,0,94,0,94,BR23
MD,BR23,0,25,0,25,BR23
MD,BR23,0,66,71,137,BR23
MD,BR23,0,350,335,685,BR23
AM,BR24,0,205,78,283,BR24
AM,BR24,0,0,22,22,BR24
MD,BR24,0,43,0,43,BR24
MD,BR24,0,23,29,52,BR24
MD,BR24,0,132,42,174,BR24
AM,BR25,0,52,0,52,BR25
MD,BR25,0,59,0,59,BR25
AM,BR29,0,220,206,426,BR29
AM,BR29,0,53,113,166,BR29
MD,BR29,0,17,0,17,BR29
MD,BR29,0,23,103,126,BR29
MD,BR29,0,261,96,357,BR29
AM,BR30,0,350,140,490,BR30
AM,BR30,0,50,71,121,BR30
MD,BR30,0,0,57,57,BR30
MD,BR30,0,54,0,54,BR30
MD,BR30,0,73,31,104,BR30
MD,BR30,0,159,167,326,BR30
MD,BR31,0,28,0,28,BR31
AM,BR32,0,0,25,25,BR32
MD,BR32,0,0,25,25,BR32
MD,BR32,0,102,51,153,BR32
AM,BR33,0,25,0,25,BR33
MD,BR33,0,19,0,19,BR33
MD,BR35,0,23,23,46,BR35
MD,BR35,0,23,0,23,BR35
AM,BR40,0,69,49,118,BR40
AM,BR40,0,45,0,45,BR40
AM,BR40,0,0,27,27,BR40
MD,BR40,0,0,22,22,BR40
MD,BR40,0,23,0,23,BR40
MD,BR40,0,45,0,45,BR40
AM,BR50,0,165,166,331,BR50
AM,BR50,0,0,23,23,BR50
MD,BR50,0,28,0,28,BR50
MD,BR50,0,28,0,28,BR50
MD,BR50,0,82,0,82,BR50
MD,BR50,0,293,101,394,BR50
AM,BR501,0,445,550,995,BR501
AM,BR501,0,789,419,1208,BR501
AM,BR501,0,22,22,44,BR501
MD,BR501,0,88,28,116,BR501
MD,BR501,0,744,610,1354,BR501
MD,BR501,0,910,703,1613,BR501
AM,BR502,0,299,175,474,BR502
AM,BR502,0,259,276,535,BR502
AM,BR502,0,65,0,65,BR502
AM,BR502,0,28,0,28,BR502
MD,BR502,0,77,27,104,BR502
MD,BR502,0,386,358,744,BR502
MD,BR502,0,532,467,999,BR502
AM,BR51,0,92,0,92,BR51
AM,BR51,0,74,0,74,BR51
AM,BR51,0,23,0,23,BR51
MD,BR51,0,28,0,28,BR51
MD,BR51,0,47,43,90,BR51
MD,BR51,0,98,35,133,BR51
AM,BR511,0,0,28,28,BR511
MD,BR511,0,0,28,28,BR511
AM,BR52,0,236,149,385,BR52
AM,BR52,0,84,28,112,BR52
MD,BR52,0,60,0,60,BR52
MD,BR52,0,185,101,286,BR52
MD,BR52,0,459,130,589,BR52
AM,BR53,0,144,126,270,BR53
AM,BR53,0,23,28,51,BR53
AM,BR53,0,27,0,27,BR53
MD,BR53,0,57,0,57,BR53
MD,BR53,0,23,75,98,BR53
MD,BR53,0,114,74,188,BR53
AM,BR54,0,52,23,75,BR54
MD,BR54,0,22,0,22,BR54
MD,BR54,0,68,0,68,BR54
AM,BR92,0,70,105,175,BR92
MD,BR92,0,24,28,52,BR92
AM,BR97,0,218,146,364,BR97
AM,BR97,0,45,22,67,BR97
MD,BR97,0,120,140,260,BR97
AM,BR99,0,0,19,19,BR99
AM,BT01,0,59,21,80,BT01
AM,BT01,0,0,24,24,BT01
MD,BT01,0,60,21,81,BT01
MD,BT01,0,129,24,153,BT01
AM,BT02,0,26,24,50,BT02
MD,BT02,0,47,0,47,BT02
MD,BT02,0,103,0,103,BT02
MD,BT02,0,107,50,157,BT02
AM,BT04,0,203,151,354,BT04
AM,BT04,0,59,0,59,BT04
MD,BT04,0,58,0,58,BT04
MD,BT04,0,235,95,330,BT04
AM,BT05,0,61,0,61,BT05
AM,BT05,0,0,19,19,BT05
MD,BT05,0,42,0,42,BT05
MD,BT05,0,107,23,130,BT05
AM,BT06,0,26,0,26,BT06
MD,BT06,0,21,0,21,BT06
MD,BT06,0,64,0,64,BT06
AM,BT07,0,23,47,70,BT07
AM,BT07,0,26,43,69,BT07
MD,BT07,0,62,50,112,BT07
MD,BT07,0,66,23,89,BT07
AM,BT08,0,0,66,66,BT08
AM,BT08,0,19,0,19,BT08
MD,BT08,0,15,0,15,BT08
MD,BT08,0,133,102,235,BT08
AM,BT09,0,57,71,128,BT09
AM,BT09,0,40,21,61,BT09
MD,BT09,0,71,0,71,BT09
MD,BT09,0,219,68,287,BT09
MD,BT11,0,0,26,26,BT11
MD,BT13,0,64,0,64,BT13
AM,BT97,0,21,42,63,BT97
MD,BT97,0,19,0,19,BT97
AM,BT98,0,23,0,23,BT98
MD,BT98,0,59,76,135,BT98
AM,BU01,0,83,92,175,BU01
AM,BU01,0,68,86,154,BU01
MD,BU01,0,0,28,28,BU01
MD,BU01,0,205,34,239,BU01
MD,BU01,0,166,241,407,BU01
AM,BU02,0,123,191,314,BU02
AM,BU02,0,79,25,104,BU02
MD,BU02,0,64,16,80,BU02
MD,BU02,0,21,28,49,BU02
MD,BU02,0,186,105,291,BU02
AM,BU03,0,100,23,123,BU03
AM,BU03,0,0,34,34,BU03
MD,BU03,0,25,0,25,BU03
MD,BU03,0,203,35,238,BU03
AM,BU04,0,75,22,97,BU04
AM,BU04,0,14,0,14,BU04
MD,BU04,0,22,0,22,BU04
MD,BU04,0,222,62,284,BU04
AM,BU05,0,87,38,125,BU05
MD,BU05,0,21,0,21,BU05
MD,BU05,0,54,20,74,BU05
AM,BU06,0,144,0,144,BU06
AM,BU06,0,23,0,23,BU06
MD,BU06,0,28,0,28,BU06
MD,BU06,0,35,35,70,BU06
MD,BU06,0,74,22,96,BU06
AM,BU08,0,77,0,77,BU08
AM,BU10,0,232,204,436,BU10
AM,BU10,0,46,66,112,BU10
MD,BU10,0,57,0,57,BU10
MD,BU10,0,112,39,151,BU10
MD,BU10,0,570,300,870,BU10
AM,BU101,0,29,0,29,BU101
AM,BU101,0,0,56,56,BU101
AM,BU11,0,22,34,56,BU11
AM,BU11,0,0,49,49,BU11
AM,BU11,0,22,0,22,BU11
MD,BU11,0,13,34,47,BU11
MD,BU11,0,0,51,51,BU11
MD,BU11,0,34,26,60,BU11
AM,BU12,0,76,25,101,BU12
AM,BU12,0,0,22,22,BU12
AM,BU12,0,13,0,13,BU12
MD,BU12,0,29,25,54,BU12
MD,BU12,0,139,25,164,BU12
AM,BU15,0,75,83,158,BU15
MD,BU15,0,23,0,23,BU15
MD,BU15,0,129,0,129,BU15
AM,BU21,0,50,0,50,BU21
AM,BU61,0,26,26,52,BU61
AM,BU62,0,0,50,50,BU62
MD,BU80,0,35,0,35,BU80
AM,BU96,0,0,25,25,BU96
MD,BU96,0,25,25,50,BU96
MD,BU98,0,68,0,68,BU98
AM,Canada Coach,0,73,91,164,Canada Coach
AM,Canada Coach,0,0,16,16,Canada Coach
MD,Canada Coach,0,0,14,14,Canada Coach
MD,Canada Coach,0,34,11,45,Canada Coach
MD,Canada Coach,0,0,16,16,Canada Coach
MD,Charter Bus,0,29,10,39,Charter Bus
AM,CO03,0,0,11,11,CO03
MD,CO03,0,11,32,43,CO03
AM,CO99,0,43,0,43,CO99
MD,CO99,0,46,21,67,CO99
AM,D101,0,25,29,54,D101
AM,D101,0,29,0,29,D101
MD,D101,0,0,29,29,D101
MD,D101,0,18,51,69,D101
AM,D102,0,0,54,54,D102
MD,D102,0,18,24,42,D102
AM,D103,0,127,72,199,D103
MD,D103,0,18,24,42,D103
MD,D103,0,44,0,44,D103
AM,D105,0,95,18,113,D105
MD,D105,0,29,0,29,D105
AM,D106,0,36,0,36,D106
AM,D107,0,54,73,127,D107
MD,D107,0,0,24,24,D107
MD,D107,0,0,29,29,D107
AM,D108,0,18,0,18,D108
MD,D108,0,29,0,29,D108
AM,D109,0,0,25,25,D109
AM,D110,0,67,73,140,D110
MD,D110,0,18,0,18,D110
MD,D110,0,68,80,148,D110
AM,D111,0,21,58,79,D111
MD,D111,0,24,29,53,D111
MD,D111,0,29,56,85,D111
AM,D112,0,151,83,234,D112
MD,D112,0,0,29,29,D112
MD,D112,0,15,0,15,D112
MD,D112,0,57,83,140,D112
AM,D114,0,24,0,24,D114
AM,D115,0,43,0,43,D115
AM,D117,0,25,25,50,D117
AM,D121,0,18,0,18,D121
MD,D121,0,42,0,42,D121
MD,D121,0,80,0,80,D121
MD,D122,0,15,0,15,D122
MD,D122,0,33,0,33,D122
AM,D141,0,29,72,101,D141
MD,D141,0,29,0,29,D141
AM,D197,0,146,127,273,D197
MD,D197,0,73,0,73,D197
AM,D198,0,0,29,29,D198
MD,D198,0,25,49,74,D198
AM,D218,0,97,48,145,D218
MD,D218,0,24,24,48,D218
AM,D219,0,204,160,364,D219
MD,D219,0,20,0,20,D219
MD,D219,0,54,0,54,D219
MD,D219,0,105,116,221,D219
AM,D221,0,38,43,81,D221
MD,D221,0,54,0,54,D221
MD,D221,0,16,49,65,D221
AM,D222,0,101,55,156,D222
MD,D222,0,0,30,30,D222
MD,D222,0,0,24,24,D222
MD,D222,0,85,79,164,D222
AM,D224,0,208,24,232,D224
MD,D224,0,30,0,30,D224
MD,D224,0,22,18,40,D224
MD,D224,0,79,31,110,D224
AM,D225,0,221,118,339,D225
MD,D225,0,24,0,24,D225
MD,D225,0,24,0,24,D225
MD,D225,0,103,55,158,D225
AM,D226,0,107,85,192,D226
AM,D226,0,18,0,18,D226
MD,D226,0,139,22,161,D226
AM,D232,0,27,63,90,D232
AM,D232,0,22,24,46,D232
MD,D232,0,22,24,46,D232
MD,D280,0,0,27,27,D280
MD,D292,0,0,30,30,D292
AM,D296,0,22,0,22,D296
MD,D296,0,0,22,22,D296
AM,D297,0,70,89,159,D297
MD,D297,0,116,90,206,D297
AM,D301,0,23,111,134,D301
AM,D302,0,200,68,268,D302
AM,D302,0,9,14,23,D302
AM,D302,0,28,0,28,D302
MD,D302,0,26,0,26,D302
MD,D302,0,24,0,24,D302
MD,D302,0,67,0,67,D302
MD,D302,0,124,96,220,D302
AM,D303,0,23,74,97,D303
MD,D303,0,85,0,85,D303
AM,D304,0,46,82,128,D304
AM,D304,0,23,46,69,D304
MD,D304,0,22,0,22,D304
MD,D304,0,54,46,100,D304
AM,D305,0,228,250,478,D305
AM,D305,0,0,37,37,D305
MD,D305,0,0,61,61,D305
MD,D305,0,114,131,245,D305
AM,D306,0,31,63,94,D306
AM,D306,0,0,51,51,D306
MD,D306,0,26,0,26,D306
MD,D306,0,40,40,80,D306
MD,D306,0,158,135,293,D306
AM,D308,0,0,24,24,D308
AM,D318,0,0,19,19,D318
AM,D397,0,44,68,112,D397
MD,D397,0,44,0,44,D397
MD,D398,0,38,26,64,D398
AM,D401,0,327,238,565,D401
AM,D401,0,168,168,336,D401
AM,D401,0,0,31,31,D401
MD,D401,0,29,0,29,D401
MD,D401,0,26,0,26,D401
MD,D401,0,149,139,288,D401
MD,D401,0,736,631,1367,D401
AM,D402,0,130,87,217,D402
AM,D402,0,37,45,82,D402
MD,D402,0,179,98,277,D402
MD,D402,0,238,321,559,D402
AM,D403,0,52,34,86,D403
MD,D403,0,33,23,56,D403
MD,D403,0,207,130,337,D403
AM,D405,0,83,0,83,D405
MD,D405,0,17,0,17,D405
AM,D406,0,0,164,164,D406
AM,D406,0,20,0,20,D406
MD,D406,0,19,21,40,D406
MD,D406,0,80,14,94,D406
AM,D407,0,105,92,197,D407
AM,D407,0,23,0,23,D407
MD,D407,0,34,0,34,D407
MD,D407,0,0,50,50,D407
MD,D407,0,152,187,339,D407
AM,D408,0,17,42,59,D408
AM,D408,0,44,0,44,D408
MD,D408,0,12,0,12,D408
MD,D408,0,66,43,109,D408
MD,D408,0,137,104,241,D408
AM,D409,0,91,69,160,D409
AM,D409,0,14,44,58,D409
MD,D409,0,43,0,43,D409
MD,D409,0,120,78,198,D409
AM,D410,0,158,198,356,D410
AM,D410,0,0,59,59,D410
MD,D410,0,21,0,21,D410
MD,D410,0,45,74,119,D410
MD,D410,0,167,222,389,D410
AM,D411,0,61,86,147,D411
MD,D411,0,0,47,47,D411
MD,D411,0,212,147,359,D411
AM,D412,0,124,61,185,D412
AM,D412,0,24,59,83,D412
MD,D412,0,170,208,378,D412
AM,D413,0,0,22,22,D413
AM,D413,0,34,0,34,D413
AM,D419,0,0,45,45,D419
AM,D419,0,0,31,31,D419
MD,D419,0,73,19,92,D419
AM,D420,0,174,226,400,D420
AM,D420,0,0,57,57,D420
AM,D420,0,0,61,61,D420
MD,D420,0,0,31,31,D420
MD,D420,0,109,213,322,D420
AM,D421,0,0,57,57,D421
AM,D496,0,109,59,168,D496
MD,D496,0,83,26,109,D496
AM,D497,0,0,57,57,D497
MD,D497,0,26,58,84,D497
AM,D501,0,27,71,98,D501
MD,D501,0,0,47,47,D501
AM,D606,0,16,0,16,D606
MD,D606,0,16,0,16,D606
AM,D915,0,322,497,819,D915
AM,D915,0,181,31,212,D915
AM,D915,0,0,59,59,D915
MD,D915,0,20,0,20,D915
MD,D915,0,112,145,257,D915
MD,D915,0,510,404,914,D915
AM,D916,0,277,422,699,D916
AM,D916,0,62,103,165,D916
MD,D916,0,34,0,34,D916
MD,D916,0,164,84,248,D916
MD,D916,0,381,395,776,D916
AM,D922,0,51,128,179,D922
AM,D922,0,18,26,44,D922
AM,D922,0,31,0,31,D922
MD,D922,0,26,60,86,D922
AM,D923,0,27,0,27,D923
AM,D923,0,18,90,108,D923
MD,D923,0,18,27,45,D923
MD,D923,0,105,84,189,D923
AM,D950,0,0,23,23,D950
MD,D950,0,62,23,85,D950
AM,Erindale School,0,0,29,29,Erindale School
AM,Erindale School,0,0,74,74,Erindale School
MD,Erindale School,0,0,17,17,Erindale School
MD,Erindale School,0,37,42,79,Erindale School
MD,Erindale School,0,0,28,28,Erindale School
AM,FE99,0,0,26,26,FE99
MD,FE99,0,16,47,63,FE99
AM,GB12,0,42,25,67,GB12
AM,GB12,0,0,22,22,GB12
MD,GB12,0,0,26,26,GB12
MD,GB12,0,25,0,25,GB12
MD,GB12,0,0,35,35,GB12
AM,GB15,0,140,147,287,GB15
AM,GB15,0,205,76,281,GB15
AM,GB15,0,0,65,65,GB15
AM,GB15,0,21,0,21,GB15
MD,GB15,0,0,52,52,GB15
MD,GB15,0,117,112,229,GB15
MD,GB15,0,85,46,131,GB15
AM,GB16,0,365,190,555,GB16
AM,GB16,0,140,56,196,GB16
AM,GB16,0,0,56,56,GB16
MD,GB16,0,17,47,64,GB16
MD,GB16,0,177,111,288,GB16
MD,GB16,0,163,188,351,GB16
AM,GB19,0,328,204,532,GB19
AM,GB19,0,76,100,176,GB19
AM,GB19,0,27,0,27,GB19
MD,GB19,0,17,28,45,GB19
MD,GB19,0,71,28,99,GB19
AM,GB20,0,53,33,86,GB20
AM,GB20,0,27,32,59,GB20
MD,GB20,0,27,33,60,GB20
AM,GB21,0,442,479,921,GB21
AM,GB21,0,169,45,214,GB21
AM,GB21,0,28,0,28,GB21
AM,GB21,0,0,21,21,GB21
MD,GB21,0,121,155,276,GB21
MD,GB21,0,658,670,1328,GB21
AM,GB25,0,124,72,196,GB25
AM,GB25,0,0,29,29,GB25
MD,GB25,0,52,29,81,GB25
MD,GB25,0,19,0,19,GB25
AM,GB27,0,115,258,373,GB27
AM,GB27,0,0,79,79,GB27
MD,GB27,0,33,0,33,GB27
AM,GB29,0,77,15,92,GB29
AM,GB29,0,85,0,85,GB29
MD,GB29,0,59,0,59,GB29
MD,GB29,0,0,57,57,GB29
MD,GB30,0,0,8,8,GB30
AM,GB31,0,126,52,178,GB31
AM,GB31,0,52,0,52,GB31
AM,GB31,0,21,0,21,GB31
MD,GB31,0,23,29,52,GB31
MD,GB31,0,144,0,144,GB31
MD,GB31,0,260,257,517,GB31
AM,GB32,0,130,111,241,GB32
AM,GB32,0,51,28,79,GB32
MD,GB32,0,19,0,19,GB32
AM,GB33,0,22,22,44,GB33
AM,GB33,0,14,0,14,GB33
MD,GB33,0,29,0,29,GB33
MD,GB33,0,14,0,14,GB33
AM,GB34,0,634,263,897,GB34
AM,GB34,0,257,28,285,GB34
AM,GB34,0,73,88,161,GB34
AM,GB34,0,0,32,32,GB34
MD,GB34,0,0,23,23,GB34
MD,GB34,0,43,0,43,GB34
MD,GB34,0,120,18,138,GB34
MD,GB34,0,259,340,599,GB34
AM,GB37,0,67,39,106,GB37
AM,GB38,0,130,55,185,GB38
MD,GB38,0,28,0,28,GB38
MD,GB38,0,13,41,54,GB38
AM,GB40,0,17,17,34,GB40
AM,GB40,0,0,30,30,GB40
MD,GB40,0,36,17,53,GB40
AM,GB46,0,1153,1007,2160,GB46
AM,GB46,0,612,562,1174,GB46
AM,GB46,0,117,68,185,GB46
AM,GB46,0,0,28,28,GB46
MD,GB46,0,29,85,114,GB46
MD,GB46,0,392,394,786,GB46
MD,GB46,0,1213,1220,2433,GB46
AM,GB52,0,947,384,1331,GB52
AM,GB52,0,262,360,622,GB52
AM,GB52,0,115,82,197,GB52
AM,GB52,0,0,32,32,GB52
MD,GB52,0,60,152,212,GB52
MD,GB52,0,210,434,644,GB52
MD,GB52,0,894,641,1535,GB52
AM,GB61,0,187,91,278,GB61
AM,GB61,0,0,28,28,GB61
MD,GB61,0,0,27,27,GB61
MD,GB61,0,45,0,45,GB61
MD,GB61,0,28,158,186,GB61
AM,GB65,0,193,27,220,GB65
AM,GB65,0,15,0,15,GB65
MD,GB65,0,49,18,67,GB65
MD,GB65,0,34,40,74,GB65
MD,GB65,0,324,172,496,GB65
AM,GB66,0,173,137,310,GB66
AM,GB66,0,60,0,60,GB66
MD,GB66,0,0,60,60,GB66
MD,GB66,0,35,0,35,GB66
MD,GB66,0,14,13,27,GB66
MD,GB66,0,44,22,66,GB66
AM,GB69,0,38,0,38,GB69
MD,GB69,0,0,62,62,GB69
AM,GB71,0,207,150,357,GB71
AM,GB71,0,41,0,41,GB71
MD,GB71,0,52,0,52,GB71
MD,GB71,0,288,162,450,GB71
AM,GB81,0,101,94,195,GB81
AM,GB81,0,0,19,19,GB81
MD,GB81,0,0,12,12,GB81
MD,GB81,0,56,23,79,GB81
AM,GB88,0,19,0,19,GB88
MD,GB88,0,12,10,22,GB88
MD,GB88,0,63,46,109,GB88
AM,GB90,0,95,240,335,GB90
MD,GB90,0,0,47,47,GB90
MD,GB90,0,19,52,71,GB90
AM,GB93,0,173,0,173,GB93
AM,GB93,0,0,33,33,GB93
AM,GB93,0,0,30,30,GB93
AM,GB93,0,0,34,34,GB93
MD,GB93,0,47,45,92,GB93
MD,GB93,0,26,68,94,GB93
MD,GB93,0,94,0,94,GB93
MD,GB93,0,186,95,281,GB93
AM,GB94,0,759,601,1360,GB94
AM,GB94,0,316,378,694,GB94
AM,GB94,0,34,61,95,GB94
AM,GB94,0,17,0,17,GB94
MD,GB94,0,24,0,24,GB94
MD,GB94,0,49,29,78,GB94
MD,GB94,0,30,46,76,GB94
MD,GB94,0,353,249,602,GB94
MD,GB94,0,737,549,1286,GB94
AM,GB95,0,265,125,390,GB95
AM,GB95,0,86,15,101,GB95
MD,GB95,0,27,92,119,GB95
MD,GB95,0,80,44,124,GB95
AM,GB96,0,200,177,377,GB96
AM,GB96,0,41,0,41,GB96
AM,GB96,0,0,32,32,GB96
MD,GB96,0,14,64,78,GB96
AM,Grey Coach,0,26,83,109,Grey Coach
AM,Grey Hound,0,404,138,542,Grey Hound
AM,Grey Hound,0,35,0,35,Grey Hound
AM,Grey Hound,0,0,52,52,Grey Hound
MD,Grey Hound,0,0,57,57,Grey Hound
MD,Grey Hound,0,35,13,48,Grey Hound
MD,Grey Hound,0,276,162,438,Grey Hound
AM,GT01,0,10903,12355,23258,GT01
AM,GT01,0,1294,1645,2939,GT01
AM,GT01,0,163,60,223,GT01
AM,GT01,0,0,22,22,GT01
MD,GT01,0,0,39,39,GT01
MD,GT01,0,113,95,208,GT01
MD,GT01,0,909,809,1718,GT01
MD,GT01,0,1465,1580,3045,GT01
AM,GT02,0,7220,7595,14815,GT02
AM,GT02,0,694,1046,1740,GT02
AM,GT02,0,0,109,109,GT02
MD,GT02,0,0,20,20,GT02
MD,GT02,0,131,77,208,GT02
MD,GT02,0,359,359,718,GT02
AM,GT03,0,5057,3684,8741,GT03
AM,GT03,0,574,648,1222,GT03
AM,GT03,0,76,51,127,GT03
AM,GT03,0,28,0,28,GT03
MD,GT03,0,0,28,28,GT03
MD,GT03,0,28,0,28,GT03
MD,GT03,0,147,237,384,GT03
MD,GT03,0,271,486,757,GT03
AM,GT05,0,4788,4551,9339,GT05
AM,GT05,0,111,91,202,GT05
MD,GT05,0,221,168,389,GT05
MD,GT05,0,170,155,325,GT05
AM,GT06,28,2833,3285,6146,GT06
AM,GT06,0,265,336,601,GT06
MD,GT06,0,85,20,105,GT06
MD,GT06,0,39,83,122,GT06
AM,GT07,0,4461,3886,8347,GT07
AM,GT07,0,380,341,721,GT07
AM,GT07,0,0,21,21,GT07
MD,GT07,0,90,52,142,GT07
MD,GT07,0,231,279,510,GT07
AM,GT09,0,10845,8570,19415,GT09
AM,GT09,0,1484,1469,2953,GT09
AM,GT09,0,70,44,114,GT09
AM,GT09,0,17,0,17,GT09
MD,GT09,0,0,26,26,GT09
MD,GT09,0,158,86,244,GT09
MD,GT09,0,621,697,1318,GT09
MD,GT09,0,1591,1224,2815,GT09
AM,GU01,0,29,29,58,GU01
MD,GU01,0,15,11,26,GU01
MD,GU01,0,41,47,88,GU01
AM,GU03,0,69,66,135,GU03
AM,GU03,0,0,11,11,GU03
MD,GU03,0,117,49,166,GU03
MD,GU04,0,17,46,63,GU04
AM,GU06,0,20,71,91,GU06
MD,GU06,0,0,19,19,GU06
AM,GU07,0,0,17,17,GU07
MD,GU07,0,35,19,54,GU07
AM,GU08,0,29,0,29,GU08
AM,GU08,0,20,30,50,GU08
MD,GU08,0,21,0,21,GU08
MD,GU08,0,34,14,48,GU08
AM,GU09,0,0,30,30,GU09
MD,GU09,0,14,20,34,GU09
MD,GU09,0,69,0,69,GU09
AM,GU10,0,91,49,140,GU10
MD,GU10,0,16,0,16,GU10
MD,GU10,0,20,14,34,GU10
AM,GU22,0,21,0,21,GU22
AM,GU22,0,0,19,19,GU22
MD,GU22,0,28,23,51,GU22
MD,GU22,0,21,19,40,GU22
AM,GU23,0,19,48,67,GU23
AM,GU23,0,0,11,11,GU23
MD,GU23,0,19,21,40,GU23
AM,GU24,0,54,75,129,GU24
MD,GU24,0,0,21,21,GU24
MD,GU24,0,17,17,34,GU24
AM,GU31,0,0,94,94,GU31
MD,GU31,0,30,0,30,GU31
AM,GU32,0,48,28,76,GU32
AM,GU32,0,13,56,69,GU32
AM,GU32,0,85,0,85,GU32
MD,GU32,0,114,0,114,GU32
MD,GU32,0,69,268,337,GU32
AM,GU33,0,87,61,148,GU33
AM,GU33,0,51,0,51,GU33
MD,GU33,0,36,0,36,GU33
MD,GU33,0,87,29,116,GU33
AM,GU34,0,0,22,22,GU34
MD,GU34,0,23,0,23,GU34
MD,GU34,0,0,22,22,GU34
AM,GU35,0,23,0,23,GU35
AM,GU35,0,51,0,51,GU35
MD,GU35,0,77,55,132,GU35
AM,GU37,0,51,0,51,GU37
MD,GU37,0,30,0,30,GU37
MD,GU37,0,91,0,91,GU37
MD,GU38,0,17,0,17,GU38
MD,GU38,0,70,0,70,GU38
AM,GU39,0,13,19,32,GU39
MD,GU39,0,0,28,28,GU39
AM,GU40,0,91,19,110,GU40
MD,GU40,0,90,0,90,GU40
AM,GU41,0,19,68,87,GU41
AM,GU41,0,18,0,18,GU41
MD,GU41,0,36,52,88,GU41
MD,GU42,0,0,17,17,GU42
MD,GU42,0,86,0,86,GU42
AM,GU43,0,18,48,66,GU43
MD,GU43,0,17,0,17,GU43
MD,GU43,0,74,29,103,GU43
AM,GU44,0,22,18,40,GU44
MD,GU44,0,0,58,58,GU44
MD,GU45,0,0,30,30,GU45
AM,GU50,0,28,0,28,GU50
MD,GU50,0,50,0,50,GU50
AM,GU51,0,19,0,19,GU51
AM,GU51,0,42,0,42,GU51
MD,GU51,0,0,58,58,GU51
AM,GU52,0,29,29,58,GU52
MD,GU52,0,18,48,66,GU52
MD,GU52,0,58,12,70,GU52
MD,GU54,0,18,0,18,GU54
MD,GU54,0,0,43,43,GU54
MD,GU55,0,30,0,30,GU55
MD,GU58,0,30,0,30,GU58
MD,GU61,0,14,0,14,GU61
MD,GU61,0,59,0,59,GU61
AM,GU70,0,30,30,60,GU70
MD,GU70,0,56,131,187,GU70
AM,GU71,0,0,40,40,GU71
MD,GU71,0,0,28,28,GU71
AM,GU76,0,30,0,30,GU76
MD,GU76,0,60,0,60,GU76
AM,GU97,0,0,32,32,GU97
MD,GU97,0,13,71,84,GU97
AM,GU99,0,95,106,201,GU99
AM,GU99,0,28,0,28,GU99
MD,GU99,0,53,156,209,GU99
AM,HA01,0,1327,864,2191,HA01
AM,HA01,0,360,151,511,HA01
AM,HA01,0,22,18,40,HA01
AM,HA01,0,0,32,32,HA01
MD,HA01,0,15,13,28,HA01
MD,HA01,0,354,409,763,HA01
MD,HA01,0,2082,1395,3477,HA01
AM,HA02,0,698,700,1398,HA02
AM,HA02,0,192,246,438,HA02
AM,HA02,0,20,28,48,HA02
MD,HA02,0,0,13,13,HA02
MD,HA02,0,184,253,437,HA02
MD,HA02,0,1447,953,2400,HA02
AM,HA03,0,558,135,693,HA03
MD,HA03,0,72,0,72,HA03
MD,HA03,0,360,139,499,HA03
AM,HA04,0,462,262,724,HA04
AM,HA04,0,251,131,382,HA04
MD,HA04,0,0,23,23,HA04
MD,HA04,0,291,198,489,HA04
MD,HA04,0,506,305,811,HA04
AM,HA05,0,1105,809,1914,HA05
AM,HA05,0,334,203,537,HA05
MD,HA05,0,34,0,34,HA05
MD,HA05,0,23,20,43,HA05
MD,HA05,0,237,221,458,HA05
MD,HA05,0,1599,1172,2771,HA05
AM,HA06,0,106,128,234,HA06
AM,HA06,0,56,23,79,HA06
MD,HA06,0,19,0,19,HA06
MD,HA06,0,155,96,251,HA06
AM,HA07,0,21,22,43,HA07
AM,HA07,0,58,0,58,HA07
MD,HA07,0,52,13,65,HA07
MD,HA07,0,144,18,162,HA07
AM,HA08,0,78,16,94,HA08
MD,HA08,0,37,0,37,HA08
MD,HA08,0,161,76,237,HA08
AM,HA10,0,562,455,1017,HA10
AM,HA10,0,319,361,680,HA10
AM,HA10,0,22,79,101,HA10
MD,HA10,0,31,0,31,HA10
MD,HA10,0,261,238,499,HA10
MD,HA10,0,865,686,1551,HA10
AM,HA11,0,184,251,435,HA11
AM,HA11,0,38,48,86,HA11
MD,HA11,0,31,0,31,HA11
MD,HA11,0,212,78,290,HA11
MD,HA11,0,168,290,458,HA11
AM,HA12,0,28,22,50,HA12
MD,HA12,0,14,0,14,HA12
MD,HA12,0,45,0,45,HA12
AM,HA16,0,28,0,28,HA16
MD,HA16,0,0,56,56,HA16
AM,HA18,0,0,35,35,HA18
AM,HA20,0,24,85,109,HA20
AM,HA21,0,378,213,591,HA21
AM,HA21,0,115,96,211,HA21
MD,HA21,0,23,28,51,HA21
MD,HA21,0,268,116,384,HA21
MD,HA21,0,424,505,929,HA21
AM,HA22,0,338,190,528,HA22
AM,HA22,0,71,78,149,HA22
MD,HA22,0,24,44,68,HA22
MD,HA22,0,308,299,607,HA22
AM,HA23,0,269,230,499,HA23
AM,HA23,0,68,67,135,HA23
MD,HA23,0,121,181,302,HA23
MD,HA23,0,482,266,748,HA23
AM,HA24,0,367,176,543,HA24
AM,HA24,0,25,0,25,HA24
MD,HA24,0,36,0,36,HA24
MD,HA24,0,179,56,235,HA24
MD,HA24,0,312,227,539,HA24
AM,HA25,0,185,174,359,HA25
AM,HA25,0,74,0,74,HA25
MD,HA25,0,13,0,13,HA25
MD,HA25,0,176,68,244,HA25
MD,HA25,0,581,154,735,HA25
AM,HA26,0,552,442,994,HA26
AM,HA26,0,55,0,55,HA26
MD,HA26,0,194,149,343,HA26
MD,HA26,0,276,131,407,HA26
AM,HA27,0,189,123,312,HA27
AM,HA27,0,208,259,467,HA27
MD,HA27,0,20,0,20,HA27
MD,HA27,0,175,173,348,HA27
MD,HA27,0,513,371,884,HA27
AM,HA33,0,257,183,440,HA33
AM,HA33,0,27,72,99,HA33
MD,HA33,0,0,30,30,HA33
MD,HA33,0,17,65,82,HA33
MD,HA33,0,202,53,255,HA33
AM,HA34,0,198,102,300,HA34
AM,HA34,0,102,46,148,HA34
MD,HA34,0,14,0,14,HA34
MD,HA34,0,107,0,107,HA34
MD,HA34,0,198,149,347,HA34
AM,HA35,0,357,250,607,HA35
AM,HA35,0,213,138,351,HA35
AM,HA35,0,56,131,187,HA35
MD,HA35,0,24,0,24,HA35
MD,HA35,0,246,159,405,HA35
MD,HA35,0,544,436,980,HA35
AM,HA41,0,627,439,1066,HA41
AM,HA41,0,262,298,560,HA41
AM,HA41,0,0,26,26,HA41
MD,HA41,0,0,34,34,HA41
MD,HA41,0,321,106,427,HA41
MD,HA41,0,965,656,1621,HA41
AM,HA43,0,122,150,272,HA43
AM,HA43,0,23,46,69,HA43
MD,HA43,0,0,48,48,HA43
MD,HA43,0,316,200,516,HA43
AM,HA44,0,139,183,322,HA44
AM,HA44,0,72,12,84,HA44
MD,HA44,0,22,0,22,HA44
MD,HA44,0,41,115,156,HA44
AM,HA51,0,134,195,329,HA51
AM,HA51,0,306,152,458,HA51
AM,HA51,0,0,23,23,HA51
MD,HA51,0,191,88,279,HA51
MD,HA51,0,361,318,679,HA51
AM,HA52,0,374,45,419,HA52
AM,HA52,0,24,23,47,HA52
MD,HA52,0,57,0,57,HA52
MD,HA52,0,351,155,506,HA52
AM,HA55,0,127,120,247,HA55
AM,HA55,0,113,90,203,HA55
AM,HA55,0,0,24,24,HA55
AM,HA55,0,0,28,28,HA55
MD,HA55,0,40,0,40,HA55
MD,HA55,0,22,0,22,HA55
MD,HA55,0,288,106,394,HA55
AM,HA56,0,21,0,21,HA56
AM,HA58,0,70,0,70,HA58
AM,HA58,0,0,44,44,HA58
MD,HA58,0,230,0,230,HA58
AM,HA90,0,81,68,149,HA90
MD,HA90,0,29,0,29,HA90
AM,HA91,0,22,25,47,HA91
AM,HA91,0,0,19,19,HA91
MD,HA91,0,19,0,19,HA91
AM,HA93,0,17,0,17,HA93
MD,HA93,0,35,0,35,HA93
AM,HA98,0,71,96,167,HA98
MD,HA98,0,333,120,453,HA98
AM,HA99,0,0,18,18,HA99
MD,HA99,0,0,34,34,HA99
AM,Handi-Transit / Wheel Trans,0,99,74,173,Handi-Transit / Wheel Trans
MD,Handi-Transit / Wheel Trans,0,396,105,501,Handi-Transit / Wheel Trans
AM,Island Ferry,0,239,399,638,Island Ferry
AM,Island Ferry,0,0,27,27,Island Ferry
AM,Island Ferry,0,61,0,61,Island Ferry
AM,Island Ferry,0,63,0,63,Island Ferry
AM,Island Ferry,0,57,0,57,Island Ferry
MD,Island Ferry,0,17,18,35,Island Ferry
MD,Island Ferry,0,41,33,74,Island Ferry
MD,Island Ferry,0,63,39,102,Island Ferry
MD,Island Ferry,0,185,324,509,Island Ferry
AM,LI02,0,25,0,25,LI02
MD,LI03,0,0,20,20,LI03
MD,MI97,0,26,0,26,MI97
AM,Midland Transit,0,20,28,48,Midland Transit
MD,Midland Transit,0,127,40,167,Midland Transit
AM,ML01,0,0,70,70,ML01
AM,ML01,0,17,0,17,ML01
AM,ML02,0,86,0,86,ML02
MD,ML02,0,0,27,27,ML02
MD,ML02,0,197,27,224,ML02
AM,ML03,0,27,0,27,ML03
AM,ML04,0,24,70,94,ML04
MD,ML04,0,24,50,74,ML04
AM,ML05,0,27,93,120,ML05
AM,ML06,0,27,49,76,ML06
MD,ML06,0,35,0,35,ML06
AM,ML07,0,0,27,27,ML07
MD,ML07,0,51,0,51,ML07
AM,ML90,0,24,0,24,ML90
AM,MS01,0,1151,623,1774,MS01
AM,MS01,0,691,287,978,MS01
AM,MS01,0,206,207,413,MS01
AM,MS01,0,0,24,24,MS01
MD,MS01,0,22,0,22,MS01
MD,MS01,0,19,65,84,MS01
MD,MS01,0,185,190,375,MS01
MD,MS01,0,601,555,1156,MS01
MD,MS01,0,1425,1071,2496,MS01
AM,MS03,0,911,652,1563,MS03
AM,MS03,0,154,149,303,MS03
AM,MS03,0,45,24,69,MS03
MD,MS03,0,50,79,129,MS03
MD,MS03,0,441,236,677,MS03
MD,MS03,0,774,469,1243,MS03
AM,MS04,0,106,182,288,MS04
AM,MS04,0,58,0,58,MS04
MD,MS04,0,22,0,22,MS04
MD,MS04,0,0,23,23,MS04
MD,MS04,0,189,182,371,MS04
AM,MS05,0,202,254,456,MS05
AM,MS05,0,293,229,522,MS05
AM,MS05,0,55,83,138,MS05
AM,MS05,0,14,0,14,MS05
MD,MS05,0,0,21,21,MS05
MD,MS05,0,229,120,349,MS05
MD,MS05,0,321,365,686,MS05
AM,MS06,0,239,112,351,MS06
AM,MS06,0,22,0,22,MS06
MD,MS06,0,0,27,27,MS06
MD,MS06,0,29,0,29,MS06
MD,MS06,0,37,22,59,MS06
MD,MS06,0,255,189,444,MS06
AM,MS07,0,185,172,357,MS07
AM,MS07,0,111,130,241,MS07
AM,MS07,0,0,66,66,MS07
AM,MS07,0,0,33,33,MS07
MD,MS07,0,23,0,23,MS07
MD,MS07,0,205,131,336,MS07
MD,MS07,0,231,66,297,MS07
AM,MS08,0,200,223,423,MS08
AM,MS08,0,43,0,43,MS08
MD,MS08,0,17,0,17,MS08
MD,MS08,0,19,0,19,MS08
MD,MS08,0,77,65,142,MS08
MD,MS08,0,361,203,564,MS08
AM,MS09,0,209,277,486,MS09
AM,MS09,0,46,0,46,MS09
MD,MS09,0,0,58,58,MS09
MD,MS09,0,65,73,138,MS09
MD,MS09,0,162,104,266,MS09
AM,MS10,0,415,333,748,MS10
AM,MS10,0,40,22,62,MS10
MD,MS10,0,141,51,192,MS10
MD,MS10,0,413,398,811,MS10
AM,MS101,0,153,168,321,MS101
AM,MS101,0,70,184,254,MS101
AM,MS101,0,37,33,70,MS101
AM,MS101,0,27,19,46,MS101
MD,MS101,0,24,0,24,MS101
MD,MS101,0,21,0,21,MS101
MD,MS101,0,30,45,75,MS101
MD,MS101,0,142,81,223,MS101
MD,MS102,0,21,0,21,MS102
AM,MS103,0,324,169,493,MS103
AM,MS103,0,98,101,199,MS103
AM,MS103,0,45,56,101,MS103
MD,MS103,0,23,19,42,MS103
MD,MS103,0,192,144,336,MS103
MD,MS103,0,205,234,439,MS103
AM,MS107,0,23,59,82,MS107
AM,MS107,0,190,253,443,MS107
AM,MS107,0,29,0,29,MS107
MD,MS107,0,28,0,28,MS107
MD,MS107,0,0,28,28,MS107
AM,MS11,0,180,193,373,MS11
AM,MS11,0,99,48,147,MS11
AM,MS11,0,23,55,78,MS11
MD,MS11,0,60,19,79,MS11
MD,MS11,0,52,52,104,MS11
MD,MS11,0,218,131,349,MS11
AM,MS110,0,174,329,503,MS110
AM,MS110,0,704,426,1130,MS110
AM,MS110,0,89,156,245,MS110
AM,MS110,0,0,28,28,MS110
MD,MS110,0,31,50,81,MS110
MD,MS110,0,57,110,167,MS110
MD,MS110,0,637,583,1220,MS110
MD,MS110,0,460,592,1052,MS110
AM,MS12,0,0,30,30,MS12
AM,MS12,0,31,0,31,MS12
MD,MS12,0,77,0,77,MS12
MD,MS12,0,26,0,26,MS12
MD,MS12,0,20,0,20,MS12
AM,MS13,0,486,387,873,MS13
AM,MS13,0,101,16,117,MS13
AM,MS13,0,0,24,24,MS13
MD,MS13,0,47,26,73,MS13
MD,MS13,0,67,112,179,MS13
MD,MS13,0,654,454,1108,MS13
AM,MS14,0,0,40,40,MS14
AM,MS14,0,0,62,62,MS14
AM,MS14,0,20,0,20,MS14
MD,MS14,0,29,0,29,MS14
MD,MS14,0,0,20,20,MS14
AM,MS15,0,60,31,91,MS15
AM,MS15,0,52,22,74,MS15
AM,MS15,0,0,22,22,MS15
AM,MS15,0,0,22,22,MS15
MD,MS15,0,17,0,17,MS15
MD,MS15,0,44,22,66,MS15
MD,MS15,0,41,46,87,MS15
AM,MS16,0,76,110,186,MS16
MD,MS16,0,23,0,23,MS16
MD,MS16,0,44,22,66,MS16
AM,MS17,0,17,23,40,MS17
AM,MS17,0,0,16,16,MS17
AM,MS17,0,17,0,17,MS17
AM,MS18,0,69,28,97,MS18
AM,MS18,0,40,46,86,MS18
MD,MS18,0,0,28,28,MS18
MD,MS18,0,0,30,30,MS18
AM,MS19,0,1651,1261,2912,MS19
AM,MS19,0,726,363,1089,MS19
AM,MS19,0,62,19,81,MS19
AM,MS19,0,20,21,41,MS19
MD,MS19,0,0,22,22,MS19
MD,MS19,0,74,60,134,MS19
MD,MS19,0,788,481,1269,MS19
MD,MS19,0,2541,1580,4121,MS19
AM,MS20,0,396,328,724,MS20
AM,MS20,0,72,50,122,MS20
AM,MS20,0,18,0,18,MS20
MD,MS20,0,178,60,238,MS20
MD,MS20,0,436,343,779,MS20
AM,MS21,0,38,0,38,MS21
MD,MS21,0,19,0,19,MS21
AM,MS22,0,200,26,226,MS22
AM,MS22,0,99,55,154,MS22
AM,MS22,0,108,74,182,MS22
MD,MS22,0,0,56,56,MS22
MD,MS22,0,89,29,118,MS22
MD,MS22,0,222,116,338,MS22
AM,MS23,0,204,183,387,MS23
AM,MS23,0,39,49,88,MS23
AM,MS23,0,41,0,41,MS23
MD,MS23,0,51,0,51,MS23
MD,MS23,0,188,133,321,MS23
MD,MS23,0,321,249,570,MS23
MD,MS24,0,19,0,19,MS24
MD,MS25,0,29,0,29,MS25
AM,MS26,0,951,700,1651,MS26
AM,MS26,0,388,320,708,MS26
AM,MS26,0,102,30,132,MS26
MD,MS26,0,93,96,189,MS26
MD,MS26,0,390,403,793,MS26
MD,MS26,0,456,709,1165,MS26
AM,MS27,0,18,28,46,MS27
AM,MS27,0,47,0,47,MS27
AM,MS27,0,59,0,59,MS27
AM,MS27,0,0,12,12,MS27
MD,MS27,0,24,42,66,MS27
AM,MS28,0,330,90,420,MS28
AM,MS28,0,41,130,171,MS28
MD,MS28,0,48,0,48,MS28
MD,MS28,0,168,88,256,MS28
MD,MS28,0,396,94,490,MS28
AM,MS29,0,94,152,246,MS29
AM,MS29,0,49,0,49,MS29
MD,MS29,0,41,0,41,MS29
MD,MS29,0,18,29,47,MS29
MD,MS29,0,236,69,305,MS29
AM,MS30,0,23,0,23,MS30
MD,MS30,0,20,0,20,MS30
MD,MS30,0,61,66,127,MS30
MD,MS301,0,19,0,19,MS301
AM,MS303,0,20,0,20,MS303
MD,MS303,0,22,0,22,MS303
MD,MS304,0,0,42,42,MS304
MD,MS305,0,0,17,17,MS305
MD,MS309,0,21,0,21,MS309
AM,MS31,0,109,0,109,MS31
MD,MS31,0,62,0,62,MS31
MD,MS31,0,50,0,50,MS31
MD,MS312,0,50,42,92,MS312
MD,MS313,0,22,0,22,MS313
AM,MS317,0,0,49,49,MS317
MD,MS317,0,33,20,53,MS317
MD,MS319,0,38,28,66,MS319
AM,MS32,0,0,80,80,MS32
MD,MS32,0,27,0,27,MS32
AM,MS320,0,19,0,19,MS320
AM,MS321,0,43,0,43,MS321
MD,MS328,0,20,22,42,MS328
AM,MS33,0,45,29,74,MS33
MD,MS33,0,0,29,29,MS33
MD,MS334,0,43,0,43,MS334
AM,MS34,0,290,281,571,MS34
AM,MS34,0,60,39,99,MS34
MD,MS34,0,51,14,65,MS34
MD,MS34,0,130,88,218,MS34
MD,MS34,0,305,266,571,MS34
AM,MS35,0,384,343,727,MS35
AM,MS35,0,164,76,240,MS35
AM,MS35,0,86,69,155,MS35
AM,MS35,0,70,0,70,MS35
MD,MS35,0,0,52,52,MS35
MD,MS35,0,214,137,351,MS35
MD,MS35,0,437,318,755,MS35
AM,MS36,0,92,98,190,MS36
AM,MS36,0,0,22,22,MS36
AM,MS36,0,0,13,13,MS36
MD,MS36,0,0,29,29,MS36
MD,MS36,0,40,0,40,MS36
MD,MS36,0,166,101,267,MS36
AM,MS38,0,421,313,734,MS38
AM,MS38,0,60,56,116,MS38
AM,MS38,0,19,57,76,MS38
AM,MS38,0,34,0,34,MS38
AM,MS38,0,0,17,17,MS38
MD,MS38,0,0,14,14,MS38
MD,MS38,0,42,43,85,MS38
MD,MS38,0,518,267,785,MS38
AM,MS39,0,149,116,265,MS39
AM,MS39,0,85,104,189,MS39
AM,MS39,0,0,22,22,MS39
MD,MS39,0,0,23,23,MS39
MD,MS39,0,121,27,148,MS39
MD,MS39,0,136,161,297,MS39
AM,MS41,0,139,173,312,MS41
AM,MS41,0,21,42,63,MS41
MD,MS41,0,29,0,29,MS41
MD,MS41,0,95,50,145,MS41
AM,MS42,0,275,194,469,MS42
AM,MS42,0,210,191,401,MS42
AM,MS42,0,24,22,46,MS42
AM,MS42,0,0,17,17,MS42
MD,MS42,0,104,23,127,MS42
MD,MS42,0,233,189,422,MS42
MD,MS42,0,214,95,309,MS42
AM,MS43,0,22,0,22,MS43
MD,MS43,0,25,0,25,MS43
AM,MS44,0,187,78,265,MS44
AM,MS44,0,113,143,256,MS44
AM,MS44,0,0,26,26,MS44
MD,MS44,0,50,29,79,MS44
MD,MS44,0,137,141,278,MS44
MD,MS44,0,416,265,681,MS44
AM,MS45,0,284,338,622,MS45
AM,MS45,0,57,17,74,MS45
AM,MS45,0,29,0,29,MS45
MD,MS45,0,0,21,21,MS45
MD,MS45,0,66,20,86,MS45
MD,MS45,0,215,182,397,MS45
AM,MS46,0,109,0,109,MS46
AM,MS46,0,18,0,18,MS46
AM,MS47,0,99,104,203,MS47
AM,MS47,0,0,17,17,MS47
MD,MS47,0,42,91,133,MS47
AM,MS48,0,137,116,253,MS48
AM,MS48,0,77,50,127,MS48
MD,MS48,0,22,0,22,MS48
MD,MS48,0,147,138,285,MS48
MD,MS48,0,221,171,392,MS48
AM,MS49,0,83,137,220,MS49
MD,MS49,0,0,21,21,MS49
MD,MS49,0,70,67,137,MS49
AM,MS50,0,19,0,19,MS50
AM,MS50,0,0,21,21,MS50
AM,MS50,0,0,34,34,MS50
AM,MS51,0,68,119,187,MS51
AM,MS51,0,403,323,726,MS51
AM,MS51,0,197,39,236,MS51
MD,MS51,0,19,0,19,MS51
MD,MS51,0,60,22,82,MS51
MD,MS51,0,207,406,613,MS51
AM,MS53,0,119,77,196,MS53
AM,MS53,0,187,29,216,MS53
AM,MS53,0,71,35,106,MS53
MD,MS53,0,22,0,22,MS53
MD,MS53,0,29,0,29,MS53
MD,MS53,0,106,50,156,MS53
AM,MS57,0,90,111,201,MS57
AM,MS57,0,57,20,77,MS57
AM,MS57,0,23,0,23,MS57
MD,MS57,0,0,17,17,MS57
MD,MS57,0,57,0,57,MS57
MD,MS57,0,54,0,54,MS57
MD,MS59,0,34,0,34,MS59
AM,MS61,0,525,378,903,MS61
AM,MS61,0,100,211,311,MS61
AM,MS61,0,22,0,22,MS61
AM,MS61,0,23,0,23,MS61
MD,MS61,0,47,49,96,MS61
MD,MS61,0,66,233,299,MS61
MD,MS61,0,445,488,933,MS61
AM,MS62,0,19,0,19,MS62
AM,MS62,0,0,28,28,MS62
MD,MS62,0,19,0,19,MS62
AM,MS64,0,47,89,136,MS64
AM,MS65,0,41,0,41,MS65
MD,MS65,0,28,0,28,MS65
AM,MS66,0,332,188,520,MS66
AM,MS66,0,193,169,362,MS66
AM,MS66,0,0,58,58,MS66
MD,MS66,0,48,23,71,MS66
MD,MS66,0,51,0,51,MS66
MD,MS66,0,103,112,215,MS66
MD,MS66,0,542,284,826,MS66
AM,MS67,0,0,71,71,MS67
AM,MS68,0,148,109,257,MS68
AM,MS68,0,17,0,17,MS68
MD,MS68,0,37,0,37,MS68
MD,MS68,0,81,0,81,MS68
AM,MS70,0,0,17,17,MS70
AM,MS70,0,58,0,58,MS70
AM,MS70,0,16,24,40,MS70
MD,MS71,0,0,49,49,MS71
MD,MS71,0,0,29,29,MS71
AM,MS76,0,93,50,143,MS76
AM,MS76,0,64,40,104,MS76
AM,MS76,0,49,22,71,MS76
MD,MS76,0,34,0,34,MS76
MD,MS76,0,94,28,122,MS76
MD,MS76,0,28,19,47,MS76
AM,MS82,0,18,79,97,MS82
AM,MS82,0,77,21,98,MS82
AM,MS82,0,15,0,15,MS82
MD,MS82,0,23,0,23,MS82
AM,MS89,0,334,214,548,MS89
AM,MS89,0,52,80,132,MS89
AM,MS89,0,50,23,73,MS89
MD,MS89,0,27,38,65,MS89
MD,MS89,0,91,0,91,MS89
AM,MS90,0,100,166,266,MS90
AM,MS90,0,105,32,137,MS90
AM,MS90,0,16,0,16,MS90
MD,MS90,0,22,0,22,MS90
MD,MS90,0,57,31,88,MS90
AM,MS91,0,19,98,117,MS91
MD,MS91,0,17,42,59,MS91
MD,MS91,0,17,42,59,MS91
AM,MS97,0,0,63,63,MS97
AM,MS97,0,0,23,23,MS97
MD,MS97,0,0,21,21,MS97
AM,MS98,0,46,28,74,MS98
MD,MS98,0,132,59,191,MS98
AM,MS99,0,0,23,23,MS99
AM,MS990,0,54,0,54,MS990
MD,MS990,0,0,20,20,MS990
MD,MS990,0,101,27,128,MS990
AM,NI01,0,18,25,43,NI01
MD,NI01,0,26,0,26,NI01
MD,NI01,0,156,0,156,NI01
MD,NI02,0,0,26,26,NI02
AM,NI03,0,0,26,26,NI03
MD,NI03,0,26,0,26,NI03
AM,NI04,0,0,24,24,NI04
MD,NI04,0,51,0,51,NI04
MD,NI04,0,67,18,85,NI04
AM,NI05,0,25,49,74,NI05
MD,NI05,0,0,53,53,NI05
AM,NI06,0,24,45,69,NI06
AM,NI06,0,0,18,18,NI06
MD,NI06,0,93,0,93,NI06
AM,NI10,0,24,24,48,NI10
MD,NI10,0,0,18,18,NI10
MD,NI10,0,76,0,76,NI10
AM,NI11,0,0,26,26,NI11
MD,NI11,0,0,26,26,NI11
MD,NI11,0,26,51,77,NI11
AM,NI12,0,25,18,43,NI12
MD,NI12,0,0,33,33,NI12
AM,NI14,0,72,18,90,NI14
AM,NI14,0,25,26,51,NI14
MD,NI14,0,64,25,89,NI14
AM,NI15,0,26,25,51,NI15
MD,NI15,0,26,0,26,NI15
MD,NI15,0,26,0,26,NI15
AM,NI30,0,0,26,26,NI30
MD,NI30,0,25,0,25,NI30
AM,NI31,0,80,75,155,NI31
AM,NI31,0,25,26,51,NI31
MD,NI31,0,25,0,25,NI31
MD,NI31,0,126,98,224,NI31
MD,NI97,0,20,14,34,NI97
AM,NI98,0,25,0,25,NI98
MD,NI98,0,25,0,25,NI98
AM,NI99,0,0,30,30,NI99
AM,Not Used,28,135395,118298,253721,Not Used
AM,Not Used,50,255185,211302,466537,Not Used
AM,Not Used,73,308854,252070,560997,Not Used
AM,Not Used,73,321916,261571,583560,Not Used
AM,Not Used,73,323608,263006,586687,Not Used
MD,Not Used,28,272483,188765,461276,Not Used
MD,Not Used,28,271109,187866,459003,Not Used
MD,Not Used,28,262480,181599,444107,Not Used
MD,Not Used,28,224478,153463,377969,Not Used
MD,Not Used,28,129884,86627,216539,Not Used
AM,NR55,0,0,32,32,NR55
AM,NR70,0,0,31,31,NR70
MD,NR70,0,27,0,27,NR70
MD,NR70,0,0,31,31,NR70
AM,NR75,0,0,32,32,NR75
AM,OA01,0,72,100,172,OA01
AM,OA01,0,119,155,274,OA01
AM,OA01,0,28,0,28,OA01
AM,OA01,0,45,0,45,OA01
MD,OA01,0,89,13,102,OA01
MD,OA01,0,103,13,116,OA01
MD,OA01,0,263,155,418,OA01
AM,OA02,0,22,0,22,OA02
MD,OA02,0,0,75,75,OA02
AM,OA03,0,61,40,101,OA03
MD,OA03,0,37,0,37,OA03
MD,OA03,0,125,0,125,OA03
AM,OA04,0,0,61,61,OA04
AM,OA04,0,42,34,76,OA04
MD,OA04,0,47,22,69,OA04
MD,OA04,0,28,44,72,OA04
AM,OA05,0,0,24,24,OA05
MD,OA05,0,22,22,44,OA05
AM,OA06,0,81,71,152,OA06
AM,OA06,0,37,0,37,OA06
MD,OA06,0,0,20,20,OA06
MD,OA06,0,37,49,86,OA06
AM,OA10,0,80,0,80,OA10
MD,OA10,0,18,0,18,OA10
AM,OA11,0,0,22,22,OA11
AM,OA11,0,0,44,44,OA11
AM,OA11,0,61,0,61,OA11
AM,OA13,0,262,108,370,OA13
AM,OA13,0,20,0,20,OA13
MD,OA13,0,63,0,63,OA13
MD,OA13,0,20,0,20,OA13
AM,OA14,0,295,172,467,OA14
AM,OA14,0,76,23,99,OA14
MD,OA14,0,23,0,23,OA14
MD,OA14,0,73,30,103,OA14
MD,OA14,0,391,105,496,OA14
AM,OA15,0,74,49,123,OA15
AM,OA15,0,0,23,23,OA15
MD,OA15,0,13,0,13,OA15
MD,OA15,0,70,0,70,OA15
AM,OA17,0,88,32,120,OA17
AM,OA17,0,21,0,21,OA17
MD,OA17,0,0,33,33,OA17
MD,OA17,0,63,67,130,OA17
AM,OA18,0,25,33,58,OA18
AM,OA19,0,54,199,253,OA19
MD,OA19,0,22,0,22,OA19
MD,OA19,0,0,33,33,OA19
MD,OA19,0,0,22,22,OA19
MD,OA19,0,88,144,232,OA19
AM,OA20,0,104,114,218,OA20
MD,OA20,0,34,0,34,OA20
MD,OA20,0,14,0,14,OA20
AM,OA21,0,64,118,182,OA21
MD,OA21,0,22,66,88,OA21
AM,OA22,0,25,57,82,OA22
MD,OA22,0,37,0,37,OA22
AM,OA24,0,205,66,271,OA24
AM,OA24,0,101,49,150,OA24
AM,OA24,0,58,53,111,OA24
MD,OA24,0,51,33,84,OA24
MD,OA24,0,107,0,107,OA24
MD,OA24,0,187,33,220,OA24
AM,OA25,0,0,18,18,OA25
AM,OA26,0,51,14,65,OA26
AM,OA26,0,20,0,20,OA26
AM,OA28,0,59,37,96,OA28
MD,OA28,0,59,37,96,OA28
MD,OA28,0,19,122,141,OA28
AM,OA32,0,32,32,64,OA32
MD,OA32,0,13,0,13,OA32
AM,OA33,0,20,25,45,OA33
AM,OA83,0,36,18,54,OA83
AM,OA97,0,22,24,46,OA97
MD,OA97,0,64,0,64,OA97
AM,OA99,0,0,33,33,OA99
MD,OR01,0,12,0,12,OR01
AM,OR02,0,0,26,26,OR02
AM,OR02,0,26,0,26,OR02
MD,OR02,0,26,0,26,OR02
MD,OR02,0,76,0,76,OR02
AM,OR03,0,26,0,26,OR03
MD,OR03,0,12,0,12,OR03
MD,OR03,0,26,29,55,OR03
AM,OR04,0,26,0,26,OR04
AM,OR04,0,25,0,25,OR04
MD,OR04,0,62,10,72,OR04
AM,OR05,0,51,0,51,OR05
MD,OR05,0,102,99,201,OR05
AM,OV01,0,39,19,58,OV01
MD,OV01,0,33,16,49,OV01
MD,OV01,0,50,16,66,OV01
MD,OV02,0,20,0,20,OV02
MD,OV02,0,92,16,108,OV02
MD,OV03,0,13,16,29,OV03
MD,OV03,0,40,16,56,OV03
AM,PE01,0,119,111,230,PE01
AM,PE01,0,39,0,39,PE01
MD,PE01,0,0,76,76,PE01
MD,PE01,0,141,26,167,PE01
AM,PE02,0,53,46,99,PE02
AM,PE02,0,54,0,54,PE02
MD,PE02,0,91,26,117,PE02
MD,PE02,0,72,66,138,PE02
MD,PE03,0,26,0,26,PE03
MD,PE03,0,44,12,56,PE03
MD,PE03,0,65,36,101,PE03
AM,PE04,0,65,19,84,PE04
AM,PE04,0,48,76,124,PE04
MD,PE04,0,46,19,65,PE04
MD,PE04,0,106,199,305,PE04
AM,PE05,0,101,47,148,PE05
AM,PE05,0,12,0,12,PE05
MD,PE05,0,39,0,39,PE05
MD,PE05,0,46,224,270,PE05
AM,PE06,0,75,48,123,PE06
AM,PE06,0,26,0,26,PE06
MD,PE06,0,76,0,76,PE06
MD,PE06,0,248,63,311,PE06
AM,PE07,0,210,0,210,PE07
AM,PE07,0,0,93,93,PE07
MD,PE07,0,46,0,46,PE07
MD,PE07,0,114,46,160,PE07
AM,PE08,0,75,76,151,PE08
AM,PE08,0,0,10,10,PE08
MD,PE08,0,77,122,199,PE08
MD,PE08,0,146,23,169,PE08
AM,PE09,0,66,0,66,PE09
AM,PE09,0,0,28,28,PE09
MD,PE09,0,38,0,38,PE09
MD,PE09,0,77,46,123,PE09
AM,PE10,0,19,0,19,PE10
MD,PE10,0,0,110,110,PE10
MD,PE10,0,97,12,109,PE10
AM,PE11,0,81,120,201,PE11
MD,PE11,0,0,19,19,PE11
MD,PE11,0,137,19,156,PE11
AM,PE12,0,46,19,65,PE12
AM,PE82,0,26,0,26,PE82
AM,PE90,0,46,0,46,PE90
AM,PE90,0,48,0,48,PE90
MD,PE90,0,46,0,46,PE90
MD,PE90,0,280,46,326,PE90
MD,PE98,0,13,0,13,PE98
MD,Port Colborne Transit,0,0,29,29,Port Colborne Transit
AM,Private Bus,0,1532,1096,2628,Private Bus
AM,Private Bus,0,358,139,497,Private Bus
AM,Private Bus,0,139,194,333,Private Bus
AM,Private Bus,0,22,36,58,Private Bus
AM,Private Bus,0,0,26,26,Private Bus
MD,Private Bus,0,15,0,15,Private Bus
MD,Private Bus,0,137,76,213,Private Bus
MD,Private Bus,0,66,82,148,Private Bus
MD,Private Bus,0,2853,1682,4535,Private Bus
AM,Rockwood Transit,0,0,17,17,Rockwood Transit
MD,Rockwood Transit,0,30,0,30,Rockwood Transit
AM,SC01,0,17,52,69,SC01
MD,SC01,0,15,30,45,SC01
AM,SC02,0,30,0,30,SC02
AM,SC02,0,0,22,22,SC02
MD,SC02,0,95,23,118,SC02
AM,SC03,0,89,60,149,SC03
AM,SC03,0,0,28,28,SC03
MD,SC03,0,49,0,49,SC03
MD,SC03,0,89,0,89,SC03
AM,SC04,0,25,41,66,SC04
MD,SC04,0,229,12,241,SC04
AM,SC05,0,79,0,79,SC05
AM,SC05,0,25,0,25,SC05
MD,SC05,0,25,0,25,SC05
MD,SC05,0,111,19,130,SC05
AM,SC06,0,27,27,54,SC06
AM,SC06,0,23,47,70,SC06
MD,SC06,0,88,24,112,SC06
MD,SC06,28,71,109,208,SC06
AM,SC07,0,116,123,239,SC07
MD,SC07,0,30,0,30,SC07
MD,SC07,0,45,127,172,SC07
AM,SC08,0,90,69,159,SC08
MD,SC08,0,18,0,18,SC08
MD,SC08,0,43,0,43,SC08
MD,SC08,0,90,24,114,SC08
AM,SC09,0,17,35,52,SC09
MD,SC09,0,0,23,23,SC09
MD,SC09,0,40,31,71,SC09
AM,SC10,0,0,30,30,SC10
AM,SC10,0,39,0,39,SC10
MD,SC10,0,53,23,76,SC10
MD,SC10,0,144,27,171,SC10
AM,SC11,0,50,48,98,SC11
AM,SC11,0,30,30,60,SC11
MD,SC11,0,55,67,122,SC11
AM,SC12,0,23,28,51,SC12
AM,SC12,0,19,0,19,SC12
MD,SC12,0,18,0,18,SC12
MD,SC12,0,18,27,45,SC12
MD,SC12,0,45,0,45,SC12
AM,SC123,0,0,31,31,SC123
MD,SC14,0,61,0,61,SC14
AM,SC15,0,23,45,68,SC15
AM,SC15,0,30,0,30,SC15
MD,SC15,0,0,25,25,SC15
MD,SC15,0,54,0,54,SC15
AM,SC16,0,58,102,160,SC16
AM,SC16,0,105,134,239,SC16
MD,SC16,0,0,14,14,SC16
MD,SC16,0,24,30,54,SC16
MD,SC16,0,201,119,320,SC16
AM,SC17,0,45,75,120,SC17
AM,SC17,0,0,46,46,SC17
MD,SC17,0,23,30,53,SC17
MD,SC17,0,136,84,220,SC17
AM,SC18,0,0,23,23,SC18
AM,SC18,0,23,23,46,SC18
MD,SC18,0,37,33,70,SC18
MD,SC18,0,145,41,186,SC18
AM,SC20,0,60,31,91,SC20
AM,SC20,0,17,0,17,SC20
MD,SC20,0,83,33,116,SC20
AM,SC21,0,0,31,31,SC21
MD,SC21,0,0,31,31,SC21
AM,SC25,0,27,28,55,SC25
AM,SC25,0,90,71,161,SC25
MD,SC25,0,57,30,87,SC25
MD,SC25,0,60,58,118,SC25
AM,SC46,0,25,0,25,SC46
AM,SC46,0,0,30,30,SC46
MD,SC46,0,52,54,106,SC46
MD,SC46,0,87,0,87,SC46
AM,SC51,0,75,79,154,SC51
MD,SC51,0,19,0,19,SC51
AM,SC52,0,28,0,28,SC52
AM,SC56,0,47,0,47,SC56
MD,SC56,0,51,12,63,SC56
MD,SC59,0,19,12,31,SC59
MD,SC60,0,55,0,55,SC60
MD,SC62,0,23,0,23,SC62
AM,SC65,0,52,0,52,SC65
MD,SC65,0,30,0,30,SC65
AM,SC66,0,30,27,57,SC66
MD,SC66,0,34,0,34,SC66
MD,SC66,0,60,27,87,SC66
MD,SC67,0,0,14,14,SC67
MD,SC67,0,0,15,15,SC67
AM,SC68,0,30,30,60,SC68
AM,SC72,0,28,0,28,SC72
MD,SC72,0,28,63,91,SC72
MD,SC98,0,61,0,61,SC98
AM,SN97,0,32,0,32,SN97
AM,SN97,0,30,0,30,SN97
AM,ZZ005,0,334,258,592,T005
AM,ZZ005,0,60,75,135,T005
AM,ZZ005,0,22,0,22,T005
AM,ZZ005,0,35,0,35,T005
MD,ZZ005,0,13,16,29,T005
MD,ZZ005,0,316,148,464,T005
AM,ZZ006,0,354,318,672,T006
AM,ZZ006,0,809,298,1107,T006
AM,ZZ006,0,835,210,1045,T006
AM,ZZ006,0,304,17,321,T006
AM,ZZ006,0,60,0,60,T006
MD,ZZ006,0,23,24,47,T006
MD,ZZ006,0,102,67,169,T006
MD,ZZ006,0,244,235,479,T006
MD,ZZ006,0,757,451,1208,T006
AM,ZZ007,0,2171,1342,3513,T007
AM,ZZ007,0,753,326,1079,T007
AM,ZZ007,0,335,320,655,T007
AM,ZZ007,0,30,17,47,T007
AM,ZZ007,0,18,0,18,T007
AM,ZZ007,0,16,60,76,T007
MD,ZZ007,0,35,0,35,T007
MD,ZZ007,0,78,0,78,T007
MD,ZZ007,0,184,146,330,T007
MD,ZZ007,0,588,279,867,T007
MD,ZZ007,0,2334,695,3029,T007
AM,ZZ008,0,322,269,591,T008
AM,ZZ008,0,56,0,56,T008
AM,ZZ008,0,48,0,48,T008
AM,ZZ008,0,24,0,24,T008
MD,ZZ008,0,24,34,58,T008
MD,ZZ008,0,39,0,39,T008
MD,ZZ008,0,175,266,441,T008
AM,ZZ009,0,366,538,904,T009
AM,ZZ009,0,110,42,152,T009
AM,ZZ009,0,19,42,61,T009
MD,ZZ009,0,51,0,51,T009
MD,ZZ009,0,54,14,68,T009
MD,ZZ009,0,304,377,681,T009
AM,ZZ010,0,311,112,423,T010
AM,ZZ010,0,24,0,24,T010
AM,ZZ011,0,530,508,1038,T011
AM,ZZ011,0,470,102,572,T011
AM,ZZ011,0,326,164,490,T011
AM,ZZ011,0,40,36,76,T011
MD,ZZ011,0,28,0,28,T011
MD,ZZ011,0,114,66,180,T011
MD,ZZ011,0,150,211,361,T011
MD,ZZ011,0,461,117,578,T011
MD,ZZ011,0,1015,394,1409,T011
AM,ZZ012,0,763,959,1722,T012
AM,ZZ012,0,125,276,401,T012
AM,ZZ012,0,139,237,376,T012
AM,ZZ012,0,16,38,54,T012
MD,ZZ012,0,105,72,177,T012
MD,ZZ012,0,221,100,321,T012
MD,ZZ012,0,473,717,1190,T012
AM,ZZ014,0,183,120,303,T014
AM,ZZ014,0,22,0,22,T014
AM,ZZ014,0,13,0,13,T014
AM,ZZ014,0,28,0,28,T014
MD,ZZ014,0,27,0,27,T014
MD,ZZ014,0,22,28,50,T014
MD,ZZ014,0,187,50,237,T014
AM,ZZ015,0,184,92,276,T015
AM,ZZ015,0,64,122,186,T015
AM,ZZ015,0,71,83,154,T015
MD,ZZ015,0,37,0,37,T015
MD,ZZ015,0,19,98,117,T015
MD,ZZ015,0,187,47,234,T015
AM,ZZ016,0,943,561,1504,T016
AM,ZZ016,0,137,101,238,T016
AM,ZZ016,0,30,41,71,T016
MD,ZZ016,0,72,0,72,T016
MD,ZZ016,0,148,48,196,T016
MD,ZZ016,0,439,124,563,T016
MD,ZZ016,0,929,648,1577,T016
AM,ZZ017,0,1356,639,1995,T017
AM,ZZ017,0,400,288,688,T017
AM,ZZ017,0,245,157,402,T017
AM,ZZ017,0,0,21,21,T017
AM,ZZ017,0,0,26,26,T017
MD,ZZ017,0,60,0,60,T017
MD,ZZ017,0,22,0,22,T017
MD,ZZ017,0,145,115,260,T017
MD,ZZ017,0,387,225,612,T017
MD,ZZ017,0,817,489,1306,T017
AM,ZZ020,0,591,391,982,T020
AM,ZZ020,0,108,0,108,T020
AM,ZZ020,0,124,0,124,T020
AM,ZZ020,0,0,19,19,T020
MD,ZZ020,0,34,0,34,T020
MD,ZZ020,0,114,21,135,T020
MD,ZZ020,0,133,198,331,T020
MD,ZZ020,0,462,203,665,T020
AM,ZZ021,23,1162,864,2049,T021
AM,ZZ021,0,266,282,548,T021
AM,ZZ021,0,63,23,86,T021
AM,ZZ021,0,38,0,38,T021
AM,ZZ021,0,48,0,48,T021
MD,ZZ021,0,14,12,26,T021
MD,ZZ021,0,99,28,127,T021
MD,ZZ021,0,363,183,546,T021
MD,ZZ021,0,724,465,1189,T021
AM,ZZ022,0,449,297,746,T022
AM,ZZ022,0,59,65,124,T022
AM,ZZ022,0,140,51,191,T022
MD,ZZ022,0,0,30,30,T022
MD,ZZ022,0,23,0,23,T022
MD,ZZ022,0,266,101,367,T022
MD,ZZ022,0,104,78,182,T022
MD,ZZ022,0,567,420,987,T022
AM,ZZ023,0,711,542,1253,T023
AM,ZZ023,0,24,0,24,T023
AM,ZZ023,0,28,13,41,T023
AM,ZZ023,0,24,0,24,T023
MD,ZZ023,0,21,0,21,T023
MD,ZZ023,0,47,80,127,T023
MD,ZZ023,0,42,90,132,T023
MD,ZZ023,0,267,202,469,T023
AM,ZZ024,0,2086,1566,3652,T024
AM,ZZ024,0,834,274,1108,T024
AM,ZZ024,0,322,308,630,T024
AM,ZZ024,0,32,24,56,T024
MD,ZZ024,0,43,0,43,T024
MD,ZZ024,0,27,41,68,T024
MD,ZZ024,0,294,342,636,T024
MD,ZZ024,0,568,438,1006,T024
MD,ZZ024,0,2431,1711,4142,T024
AM,ZZ025,0,4027,2476,6503,T025
AM,ZZ025,0,1367,992,2359,T025
AM,ZZ025,0,409,345,754,T025
AM,ZZ025,0,159,138,297,T025
AM,ZZ025,0,0,122,122,T025
MD,ZZ025,0,62,34,96,T025
MD,ZZ025,0,290,80,370,T025
MD,ZZ025,0,505,360,865,T025
MD,ZZ025,0,839,534,1373,T025
MD,ZZ025,0,2843,2258,5101,T025
AM,ZZ026,0,435,284,719,T026
AM,ZZ026,0,56,52,108,T026
AM,ZZ026,0,37,30,67,T026
MD,ZZ026,0,40,0,40,T026
MD,ZZ026,0,107,17,124,T026
MD,ZZ026,0,288,132,420,T026
AM,ZZ028,0,281,145,426,T028
AM,ZZ028,0,79,0,79,T028
AM,ZZ028,0,76,0,76,T028
MD,ZZ028,0,49,38,87,T028
MD,ZZ028,0,11,0,11,T028
MD,ZZ028,0,113,62,175,T028
AM,ZZ029,0,3007,2441,5448,T029
AM,ZZ029,0,1095,671,1766,T029
AM,ZZ029,0,510,555,1065,T029
AM,ZZ029,0,107,32,139,T029
AM,ZZ029,0,22,0,22,T029
MD,ZZ029,0,15,0,15,T029
MD,ZZ029,0,48,97,145,T029
MD,ZZ029,0,386,403,789,T029
MD,ZZ029,0,1193,719,1912,T029
MD,ZZ029,0,3351,1962,5313,T029
AM,ZZ030,0,331,120,451,T030
AM,ZZ030,0,18,54,72,T030
AM,ZZ030,0,52,0,52,T030
AM,ZZ030,0,18,0,18,T030
MD,ZZ030,0,69,0,69,T030
MD,ZZ030,0,139,84,223,T030
MD,ZZ030,0,254,81,335,T030
AM,ZZ031,0,371,114,485,T031
AM,ZZ031,0,23,16,39,T031
AM,ZZ031,0,36,0,36,T031
AM,ZZ031,0,0,12,12,T031
MD,ZZ031,0,53,0,53,T031
MD,ZZ031,0,48,26,74,T031
MD,ZZ031,0,216,78,294,T031
AM,ZZ032,0,4355,3012,7367,T032
AM,ZZ032,0,1403,1279,2682,T032
AM,ZZ032,0,300,227,527,T032
AM,ZZ032,0,149,21,170,T032
AM,ZZ032,0,0,22,22,T032
MD,ZZ032,0,23,0,23,T032
MD,ZZ032,0,33,0,33,T032
MD,ZZ032,0,118,0,118,T032
MD,ZZ032,0,180,186,366,T032
MD,ZZ032,0,1278,747,2025,T032
MD,ZZ032,0,3202,2139,5341,T032
AM,ZZ033,0,89,56,145,T033
AM,ZZ033,0,23,40,63,T033
AM,ZZ033,0,22,18,40,T033
MD,ZZ033,0,32,10,42,T033
MD,ZZ033,0,32,17,49,T033
AM,ZZ034,0,2639,1681,4320,T034
AM,ZZ034,0,1326,919,2245,T034
AM,ZZ034,0,725,486,1211,T034
AM,ZZ034,0,76,92,168,T034
AM,ZZ034,0,43,20,63,T034
MD,ZZ034,0,24,24,48,T034
MD,ZZ034,0,206,153,359,T034
MD,ZZ034,0,331,93,424,T034
MD,ZZ034,0,1371,786,2157,T034
MD,ZZ034,0,2123,1423,3546,T034
AM,ZZ035,0,3953,2823,6776,T035
AM,ZZ035,0,871,799,1670,T035
AM,ZZ035,0,485,117,602,T035
AM,ZZ035,0,32,33,65,T035
MD,ZZ035,0,46,0,46,T035
MD,ZZ035,0,117,60,177,T035
MD,ZZ035,0,356,287,643,T035
MD,ZZ035,0,1237,679,1916,T035
MD,ZZ035,0,3821,1651,5472,T035
AM,ZZ036,0,3469,2871,6340,T036
AM,ZZ036,0,1512,1296,2808,T036
AM,ZZ036,0,381,254,635,T036
AM,ZZ036,0,82,10,92,T036
AM,ZZ036,0,0,30,30,T036
MD,ZZ036,0,13,68,81,T036
MD,ZZ036,0,491,155,646,T036
MD,ZZ036,0,1765,854,2619,T036
MD,ZZ036,0,2574,1853,4427,T036
AM,ZZ037,0,1614,1327,2941,T037
AM,ZZ037,0,463,267,730,T037
AM,ZZ037,0,238,196,434,T037
AM,ZZ037,0,29,25,54,T037
MD,ZZ037,0,48,0,48,T037
MD,ZZ037,0,293,145,438,T037
MD,ZZ037,0,578,349,927,T037
MD,ZZ037,0,1350,700,2050,T037
AM,ZZ038,0,572,242,814,T038
AM,ZZ038,0,254,118,372,T038
AM,ZZ038,0,154,29,183,T038
AM,ZZ038,0,0,23,23,T038
AM,ZZ038,0,0,61,61,T038
MD,ZZ038,0,28,0,28,T038
MD,ZZ038,0,131,124,255,T038
MD,ZZ038,0,418,118,536,T038
MD,ZZ038,0,633,408,1041,T038
MD,ZZ038,0,994,242,1236,T038
AM,ZZ039,0,3325,2521,5846,T039
AM,ZZ039,0,1298,866,2164,T039
AM,ZZ039,0,184,169,353,T039
AM,ZZ039,0,149,110,259,T039
AM,ZZ039,0,29,0,29,T039
MD,ZZ039,0,31,0,31,T039
MD,ZZ039,0,91,29,120,T039
MD,ZZ039,0,135,188,323,T039
MD,ZZ039,0,1068,1014,2082,T039
MD,ZZ039,0,2275,2061,4336,T039
AM,ZZ040,0,340,260,600,T040
AM,ZZ040,0,42,0,42,T040
AM,ZZ040,0,28,0,28,T040
AM,ZZ040,0,0,32,32,T040
MD,ZZ040,0,21,15,36,T040
MD,ZZ040,0,99,77,176,T040
MD,ZZ040,0,73,34,107,T040
MD,ZZ040,0,341,296,637,T040
AM,ZZ041,0,1700,1507,3207,T041
AM,ZZ041,22,678,887,1587,T041
AM,ZZ041,0,392,151,543,T041
AM,ZZ041,0,56,0,56,T041
MD,ZZ041,0,20,28,48,T041
MD,ZZ041,0,628,396,1024,T041
MD,ZZ041,0,880,803,1683,T041
MD,ZZ041,0,1845,1064,2909,T041
AM,ZZ042,0,1192,897,2089,T042
AM,ZZ042,0,542,206,748,T042
AM,ZZ042,0,49,82,131,T042
AM,ZZ042,0,40,0,40,T042
MD,ZZ042,0,13,31,44,T042
MD,ZZ042,0,103,28,131,T042
MD,ZZ042,0,202,32,234,T042
MD,ZZ042,0,410,436,846,T042
AM,ZZ043,0,1463,968,2431,T043
AM,ZZ043,0,544,238,782,T043
AM,ZZ043,0,219,281,500,T043
AM,ZZ043,0,0,77,77,T043
MD,ZZ043,0,38,49,87,T043
MD,ZZ043,0,244,271,515,T043
MD,ZZ043,0,558,416,974,T043
MD,ZZ043,0,1298,693,1991,T043
AM,ZZ044,0,403,432,835,T044
AM,ZZ044,0,585,388,973,T044
AM,ZZ044,0,505,560,1065,T044
AM,ZZ044,0,162,56,218,T044
MD,ZZ044,0,47,0,47,T044
MD,ZZ044,0,82,144,226,T044
MD,ZZ044,0,507,325,832,T044
MD,ZZ044,0,538,418,956,T044
AM,ZZ045,0,2168,1708,3876,T045
AM,ZZ045,0,475,532,1007,T045
AM,ZZ045,0,330,185,515,T045
AM,ZZ045,0,42,22,64,T045
AM,ZZ045,0,0,18,18,T045
MD,ZZ045,0,0,24,24,T045
MD,ZZ045,0,184,166,350,T045
MD,ZZ045,0,442,434,876,T045
MD,ZZ045,0,1564,1127,2691,T045
AM,ZZ046,0,891,469,1360,T046
AM,ZZ046,0,272,305,577,T046
AM,ZZ046,0,20,38,58,T046
AM,ZZ046,0,0,33,33,T046
MD,ZZ046,0,34,17,51,T046
MD,ZZ046,0,103,0,103,T046
MD,ZZ046,0,87,164,251,T046
MD,ZZ046,0,468,326,794,T046
AM,ZZ047,0,1123,531,1654,T047
AM,ZZ047,0,264,86,350,T047
AM,ZZ047,0,285,63,348,T047
AM,ZZ047,0,101,49,150,T047
AM,ZZ047,0,26,0,26,T047
MD,ZZ047,0,40,0,40,T047
MD,ZZ047,0,116,32,148,T047
MD,ZZ047,0,199,13,212,T047
MD,ZZ047,0,311,225,536,T047
MD,ZZ047,0,825,598,1423,T047
AM,ZZ048,0,245,236,481,T048
AM,ZZ048,0,21,44,65,T048
AM,ZZ048,0,34,22,56,T048
AM,ZZ048,0,41,0,41,T048
MD,ZZ048,0,65,65,130,T048
MD,ZZ048,0,112,67,179,T048
MD,ZZ048,0,284,168,452,T048
AM,ZZ049,0,603,386,989,T049
AM,ZZ049,0,85,90,175,T049
AM,ZZ049,0,19,18,37,T049
MD,ZZ049,0,49,12,61,T049
MD,ZZ049,0,89,21,110,T049
MD,ZZ049,0,251,208,459,T049
AM,ZZ050,0,573,331,904,T050
AM,ZZ050,0,84,47,131,T050
AM,ZZ050,0,0,58,58,T050
MD,ZZ050,0,0,44,44,T050
MD,ZZ050,0,54,29,83,T050
MD,ZZ050,0,222,233,455,T050
AM,ZZ051,0,369,481,850,T051
AM,ZZ051,0,120,116,236,T051
AM,ZZ051,0,21,0,21,T051
AM,ZZ051,0,80,0,80,T051
AM,ZZ051,0,40,23,63,T051
MD,ZZ051,0,0,33,33,T051
MD,ZZ051,0,11,23,34,T051
MD,ZZ051,0,24,0,24,T051
MD,ZZ051,0,118,38,156,T051
MD,ZZ051,0,260,108,368,T051
AM,ZZ052,0,2217,1615,3832,T052
AM,ZZ052,0,1174,700,1874,T052
AM,ZZ052,0,515,270,785,T052
AM,ZZ052,0,221,101,322,T052
AM,ZZ052,0,86,0,86,T052
MD,ZZ052,0,14,12,26,T052
MD,ZZ052,0,129,71,200,T052
MD,ZZ052,0,506,102,608,T052
MD,ZZ052,0,1230,464,1694,T052
MD,ZZ052,0,2640,1074,3714,T052
AM,ZZ053,0,2544,2208,4752,T053
AM,ZZ053,0,498,799,1297,T053
AM,ZZ053,0,175,196,371,T053
AM,ZZ053,0,36,34,70,T053
MD,ZZ053,0,24,29,53,T053
MD,ZZ053,0,47,64,111,T053
MD,ZZ053,0,79,100,179,T053
MD,ZZ053,0,567,343,910,T053
MD,ZZ053,0,1406,1318,2724,T053
AM,ZZ054,0,3000,2406,5406,T054
AM,ZZ054,0,979,671,1650,T054
AM,ZZ054,0,302,122,424,T054
AM,ZZ054,0,160,53,213,T054
AM,ZZ054,0,19,0,19,T054
MD,ZZ054,0,27,15,42,T054
MD,ZZ054,0,43,22,65,T054
MD,ZZ054,0,232,28,260,T054
MD,ZZ054,0,272,213,485,T054
MD,ZZ054,0,1009,584,1593,T054
MD,ZZ054,0,2846,1633,4479,T054
AM,ZZ055,0,107,99,206,T055
MD,ZZ055,0,0,11,11,T055
MD,ZZ055,0,197,67,264,T055
AM,ZZ056,0,221,323,544,T056
AM,ZZ056,0,172,121,293,T056
AM,ZZ056,0,46,85,131,T056
AM,ZZ056,0,0,22,22,T056
MD,ZZ056,0,54,18,72,T056
MD,ZZ056,0,68,82,150,T056
MD,ZZ056,0,164,123,287,T056
AM,ZZ057,0,1053,1207,2260,T057
AM,ZZ057,0,630,710,1340,T057
AM,ZZ057,0,139,186,325,T057
AM,ZZ057,0,0,95,95,T057
MD,ZZ057,0,0,32,32,T057
MD,ZZ057,0,54,36,90,T057
MD,ZZ057,0,347,167,514,T057
MD,ZZ057,0,1008,731,1739,T057
AM,ZZ058,0,544,482,1026,T058
AM,ZZ058,0,631,346,977,T058
AM,ZZ058,0,132,105,237,T058
AM,ZZ058,0,18,23,41,T058
MD,ZZ058,0,87,152,239,T058
MD,ZZ058,0,381,143,524,T058
MD,ZZ058,0,678,411,1089,T058
AM,ZZ059,0,276,204,480,T059
AM,ZZ059,0,0,176,176,T059
AM,ZZ059,22,0,13,35,T059
AM,ZZ059,0,0,21,21,T059
MD,ZZ059,0,0,29,29,T059
MD,ZZ059,0,84,0,84,T059
MD,ZZ059,0,63,257,320,T059
AM,ZZ060,0,2126,1876,4002,T060
AM,ZZ060,0,1364,932,2296,T060
AM,ZZ060,0,310,266,576,T060
AM,ZZ060,0,110,79,189,T060
MD,ZZ060,0,0,13,13,T060
MD,ZZ060,0,14,51,65,T060
MD,ZZ060,0,242,315,557,T060
MD,ZZ060,0,822,882,1704,T060
MD,ZZ060,0,1700,952,2652,T060
AM,ZZ061,0,383,255,638,T061
AM,ZZ061,0,160,87,247,T061
AM,ZZ061,0,88,51,139,T061
AM,ZZ061,0,90,16,106,T061
MD,ZZ061,0,53,0,53,T061
MD,ZZ061,0,0,24,24,T061
MD,ZZ061,0,68,26,94,T061
MD,ZZ061,0,292,310,602,T061
AM,ZZ062,0,294,353,647,T062
AM,ZZ062,0,123,70,193,T062
AM,ZZ062,0,56,0,56,T062
MD,ZZ062,0,37,12,49,T062
MD,ZZ062,0,29,27,56,T062
MD,ZZ062,0,56,74,130,T062
MD,ZZ062,0,153,295,448,T062
AM,ZZ063,0,2093,1128,3221,T063
AM,ZZ063,0,324,267,591,T063
AM,ZZ063,0,244,232,476,T063
AM,ZZ063,0,47,53,100,T063
AM,ZZ063,0,24,0,24,T063
MD,ZZ063,0,61,0,61,T063
MD,ZZ063,0,234,298,532,T063
MD,ZZ063,0,356,314,670,T063
MD,ZZ063,0,1007,773,1780,T063
AM,ZZ064,0,341,315,656,T064
AM,ZZ064,0,143,109,252,T064
AM,ZZ064,0,146,43,189,T064
MD,ZZ064,0,32,49,81,T064
MD,ZZ064,0,26,41,67,T064
MD,ZZ064,0,192,37,229,T064
MD,ZZ064,0,614,250,864,T064
AM,ZZ065,0,295,367,662,T065
AM,ZZ065,0,13,48,61,T065
AM,ZZ065,0,46,68,114,T065
MD,ZZ065,0,84,33,117,T065
MD,ZZ065,0,115,32,147,T065
MD,ZZ065,0,345,64,409,T065
AM,ZZ066,0,718,488,1206,T066
AM,ZZ066,0,15,0,15,T066
AM,ZZ066,0,19,91,110,T066
AM,ZZ066,0,21,0,21,T066
MD,ZZ066,0,0,28,28,T066
MD,ZZ066,0,79,173,252,T066
MD,ZZ066,0,90,47,137,T066
MD,ZZ066,0,495,246,741,T066
AM,ZZ067,0,796,444,1240,T067
AM,ZZ067,0,141,56,197,T067
AM,ZZ067,0,97,18,115,T067
MD,ZZ067,0,34,0,34,T067
MD,ZZ067,0,212,25,237,T067
MD,ZZ067,0,52,56,108,T067
MD,ZZ067,0,662,197,859,T067
AM,ZZ068,0,1486,1042,2528,T068
AM,ZZ068,0,719,479,1198,T068
AM,ZZ068,0,416,389,805,T068
AM,ZZ068,0,76,54,130,T068
AM,ZZ068,0,0,29,29,T068
MD,ZZ068,0,18,53,71,T068
MD,ZZ068,0,221,232,453,T068
MD,ZZ068,0,579,287,866,T068
MD,ZZ068,0,1090,707,1797,T068
AM,ZZ069,0,727,451,1178,T069
AM,ZZ069,0,78,92,170,T069
AM,ZZ069,0,0,92,92,T069
AM,ZZ069,0,0,33,33,T069
MD,ZZ069,0,92,84,176,T069
MD,ZZ069,0,124,140,264,T069
MD,ZZ069,0,403,234,637,T069
AM,ZZ070,0,499,446,945,T070
AM,ZZ070,0,167,180,347,T070
AM,ZZ070,0,195,125,320,T070
AM,ZZ070,0,99,35,134,T070
AM,ZZ070,0,0,16,16,T070
MD,ZZ070,0,114,0,114,T070
MD,ZZ070,0,193,75,268,T070
MD,ZZ070,0,145,135,280,T070
MD,ZZ070,0,534,467,1001,T070
AM,ZZ071,0,685,335,1020,T071
AM,ZZ071,0,49,73,122,T071
AM,ZZ071,0,173,66,239,T071
AM,ZZ071,0,28,0,28,T071
MD,ZZ071,0,17,0,17,T071
MD,ZZ071,0,177,100,277,T071
MD,ZZ071,0,109,80,189,T071
MD,ZZ071,0,304,184,488,T071
AM,ZZ072,0,501,529,1030,T072
AM,ZZ072,0,111,59,170,T072
AM,ZZ072,0,99,88,187,T072
AM,ZZ072,0,64,16,80,T072
AM,ZZ072,0,0,22,22,T072
MD,ZZ072,0,0,44,44,T072
MD,ZZ072,0,22,111,133,T072
MD,ZZ072,0,279,182,461,T072
MD,ZZ072,0,464,383,847,T072
AM,ZZ073,0,884,851,1735,T073
AM,ZZ073,0,279,256,535,T073
AM,ZZ073,0,181,24,205,T073
MD,ZZ073,0,165,107,272,T073
MD,ZZ073,0,438,118,556,T073
MD,ZZ073,0,781,421,1202,T073
AM,ZZ074,0,215,208,423,T074
AM,ZZ074,0,47,24,71,T074
AM,ZZ074,0,50,0,50,T074
AM,ZZ074,0,50,23,73,T074
MD,ZZ074,0,58,15,73,T074
MD,ZZ074,0,80,91,171,T074
AM,ZZ075,0,359,227,586,T075
AM,ZZ075,0,157,10,167,T075
AM,ZZ075,0,118,230,348,T075
AM,ZZ075,0,0,21,21,T075
MD,ZZ075,0,118,9,127,T075
MD,ZZ075,0,77,126,203,T075
MD,ZZ075,0,437,323,760,T075
AM,ZZ076,0,951,630,1581,T076
AM,ZZ076,0,560,296,856,T076
AM,ZZ076,0,394,304,698,T076
AM,ZZ076,0,49,22,71,T076
AM,ZZ076,0,0,19,19,T076
MD,ZZ076,0,13,0,13,T076
MD,ZZ076,0,133,50,183,T076
MD,ZZ076,0,127,121,248,T076
MD,ZZ076,0,638,422,1060,T076
AM,ZZ077,0,375,126,501,T077
AM,ZZ077,0,15,0,15,T077
AM,ZZ077,0,43,0,43,T077
MD,ZZ077,0,15,0,15,T077
MD,ZZ077,0,44,43,87,T077
MD,ZZ077,0,268,65,333,T077
AM,ZZ078,0,221,106,327,T078
AM,ZZ078,0,15,0,15,T078
MD,ZZ078,0,0,24,24,T078
MD,ZZ078,0,23,0,23,T078
MD,ZZ078,0,54,22,76,T078
MD,ZZ078,0,22,0,22,T078
MD,ZZ078,0,137,32,169,T078
AM,ZZ079,0,849,545,1394,T079
AM,ZZ079,0,82,37,119,T079
AM,ZZ079,0,112,21,133,T079
AM,ZZ079,0,0,20,20,T079
MD,ZZ079,0,22,0,22,T079
MD,ZZ079,0,161,43,204,T079
MD,ZZ079,0,75,71,146,T079
MD,ZZ079,0,850,511,1361,T079
AM,ZZ080,0,97,39,136,T080
AM,ZZ080,0,66,83,149,T080
AM,ZZ080,0,43,24,67,T080
AM,ZZ080,0,17,23,40,T080
MD,ZZ080,0,16,0,16,T080
MD,ZZ080,0,97,34,131,T080
MD,ZZ080,0,207,73,280,T080
AM,ZZ081,0,450,583,1033,T081
AM,ZZ081,0,37,0,37,T081
AM,ZZ081,0,17,0,17,T081
AM,ZZ081,0,0,30,30,T081
AM,ZZ081,0,27,0,27,T081
MD,ZZ081,0,35,62,97,T081
MD,ZZ081,0,70,39,109,T081
MD,ZZ081,0,565,379,944,T081
AM,ZZ082,0,70,46,116,T082
AM,ZZ082,0,39,0,39,T082
MD,ZZ082,0,27,0,27,T082
MD,ZZ082,0,11,0,11,T082
MD,ZZ082,0,15,0,15,T082
MD,ZZ082,0,35,11,46,T082
MD,ZZ082,0,87,37,124,T082
AM,ZZ083,0,156,229,385,T083
AM,ZZ083,0,79,17,96,T083
AM,ZZ083,0,19,55,74,T083
AM,ZZ083,0,0,38,38,T083
MD,ZZ083,0,30,0,30,T083
MD,ZZ083,0,59,36,95,T083
MD,ZZ083,0,205,0,205,T083
AM,ZZ084,0,1842,1200,3042,T084
AM,ZZ084,0,929,678,1607,T084
AM,ZZ084,0,191,85,276,T084
AM,ZZ084,0,143,32,175,T084
AM,ZZ084,0,16,88,104,T084
MD,ZZ084,0,132,90,222,T084
MD,ZZ084,0,302,275,577,T084
MD,ZZ084,0,920,638,1558,T084
MD,ZZ084,0,1240,787,2027,T084
AM,ZZ085,0,3225,2158,5383,T085
AM,ZZ085,0,980,265,1245,T085
AM,ZZ085,0,213,120,333,T085
AM,ZZ085,0,149,172,321,T085
AM,ZZ085,0,37,33,70,T085
AM,ZZ085,0,23,0,23,T085
MD,ZZ085,0,112,0,112,T085
MD,ZZ085,0,59,134,193,T085
MD,ZZ085,0,292,239,531,T085
MD,ZZ085,0,965,421,1386,T085
MD,ZZ085,0,2131,1386,3517,T085
AM,ZZ086,0,1831,1093,2924,T086
AM,ZZ086,0,393,192,585,T086
AM,ZZ086,0,113,109,222,T086
AM,ZZ086,0,50,61,111,T086
MD,ZZ086,0,94,0,94,T086
MD,ZZ086,0,78,90,168,T086
MD,ZZ086,0,265,276,541,T086
MD,ZZ086,0,1525,744,2269,T086
AM,ZZ087,0,1070,635,1705,T087
AM,ZZ087,0,162,38,200,T087
AM,ZZ087,0,66,0,66,T087
AM,ZZ087,0,0,19,19,T087
MD,ZZ087,0,29,0,29,T087
MD,ZZ087,0,152,43,195,T087
MD,ZZ087,0,135,77,212,T087
MD,ZZ087,0,420,376,796,T087
AM,ZZ088,0,274,461,735,T088
AM,ZZ088,0,72,0,72,T088
AM,ZZ088,0,38,42,80,T088
MD,ZZ088,0,16,0,16,T088
MD,ZZ088,0,32,10,42,T088
MD,ZZ088,0,61,10,71,T088
MD,ZZ088,0,304,98,402,T088
AM,ZZ089,0,1566,906,2472,T089
AM,ZZ089,0,268,98,366,T089
AM,ZZ089,0,106,89,195,T089
AM,ZZ089,0,33,0,33,T089
MD,ZZ089,0,30,0,30,T089
MD,ZZ089,0,276,170,446,T089
MD,ZZ089,0,383,104,487,T089
MD,ZZ089,0,1246,474,1720,T089
AM,ZZ090,0,723,641,1364,T090
AM,ZZ090,0,42,0,42,T090
AM,ZZ090,0,33,53,86,T090
AM,ZZ090,0,40,0,40,T090
MD,ZZ090,0,23,0,23,T090
MD,ZZ090,0,18,48,66,T090
MD,ZZ090,0,92,41,133,T090
MD,ZZ090,0,85,0,85,T090
MD,ZZ090,0,367,228,595,T090
AM,ZZ091,0,399,625,1024,T091
AM,ZZ091,0,113,23,136,T091
AM,ZZ091,0,119,41,160,T091
AM,ZZ091,0,47,0,47,T091
AM,ZZ091,0,19,0,19,T091
MD,ZZ091,0,0,14,14,T091
MD,ZZ091,0,56,100,156,T091
MD,ZZ091,0,33,102,135,T091
MD,ZZ091,0,293,248,541,T091
AM,ZZ092,0,126,103,229,T092
AM,ZZ092,0,22,19,41,T092
AM,ZZ092,0,54,0,54,T092
AM,ZZ092,0,52,0,52,T092
MD,ZZ092,0,17,0,17,T092
MD,ZZ092,0,17,24,41,T092
MD,ZZ092,0,59,0,59,T092
MD,ZZ092,0,101,201,302,T092
AM,ZZ094,0,757,761,1518,T094
AM,ZZ094,0,180,136,316,T094
AM,ZZ094,0,168,76,244,T094
AM,ZZ094,0,54,0,54,T094
MD,ZZ094,0,17,0,17,T094
MD,ZZ094,0,140,96,236,T094
MD,ZZ094,0,277,62,339,T094
MD,ZZ094,0,874,414,1288,T094
AM,ZZ095,0,3225,1849,5074,T095
AM,ZZ095,0,1587,1124,2711,T095
AM,ZZ095,0,529,257,786,T095
AM,ZZ095,0,84,21,105,T095
AM,ZZ095,0,42,17,59,T095
MD,ZZ095,0,79,32,111,T095
MD,ZZ095,0,464,199,663,T095
MD,ZZ095,0,1749,918,2667,T095
MD,ZZ095,0,2690,1407,4097,T095
AM,ZZ096,22,2199,1494,3715,T096
AM,ZZ096,0,1357,783,2140,T096
AM,ZZ096,0,377,205,582,T096
AM,ZZ096,0,104,153,257,T096
AM,ZZ096,0,19,52,71,T096
AM,ZZ096,0,18,0,18,T096
MD,ZZ096,0,127,152,279,T096
MD,ZZ096,0,291,173,464,T096
MD,ZZ096,0,1376,777,2153,T096
MD,ZZ096,0,2263,1217,3480,T096
AM,ZZ097,0,504,216,720,T097
AM,ZZ097,0,28,13,41,T097
AM,ZZ097,0,49,0,49,T097
AM,ZZ097,0,24,0,24,T097
MD,ZZ097,0,13,25,38,T097
MD,ZZ097,0,16,37,53,T097
MD,ZZ097,0,103,11,114,T097
MD,ZZ097,0,249,144,393,T097
AM,ZZ098,0,362,268,630,T098
AM,ZZ098,0,0,66,66,T098
AM,ZZ098,0,34,0,34,T098
MD,ZZ098,0,32,0,32,T098
MD,ZZ098,0,40,0,40,T098
MD,ZZ098,0,103,45,148,T098
MD,ZZ098,0,287,115,402,T098
MD,ZZ099,0,0,22,22,T099
AM,ZZ100,0,1267,1148,2415,T100
AM,ZZ100,0,223,134,357,T100
AM,ZZ100,0,329,126,455,T100
AM,ZZ100,0,19,24,43,T100
MD,ZZ100,0,18,22,40,T100
MD,ZZ100,0,120,132,252,T100
MD,ZZ100,0,245,158,403,T100
MD,ZZ100,0,1241,924,2165,T100
AM,ZZ102,0,1929,1798,3727,T102
AM,ZZ102,0,642,705,1347,T102
AM,ZZ102,0,288,69,357,T102
AM,ZZ102,0,99,0,99,T102
MD,ZZ102,0,35,0,35,T102
MD,ZZ102,0,235,185,420,T102
MD,ZZ102,0,630,421,1051,T102
MD,ZZ102,0,1828,1275,3103,T102
AM,ZZ103,0,72,109,181,T103
AM,ZZ103,0,0,16,16,T103
MD,ZZ103,0,0,11,11,T103
MD,ZZ103,0,38,11,49,T103
AM,ZZ104,0,235,312,547,T104
AM,ZZ104,0,99,22,121,T104
AM,ZZ104,0,17,31,48,T104
AM,ZZ104,0,17,0,17,T104
MD,ZZ104,0,43,0,43,T104
MD,ZZ104,0,60,73,133,T104
MD,ZZ104,0,232,70,302,T104
AM,ZZ105,0,473,501,974,T105
AM,ZZ105,0,122,321,443,T105
AM,ZZ105,0,124,173,297,T105
AM,ZZ105,0,47,113,160,T105
MD,ZZ105,0,23,0,23,T105
MD,ZZ105,0,113,0,113,T105
MD,ZZ105,0,172,49,221,T105
MD,ZZ105,0,601,274,875,T105
AM,ZZ106,0,807,404,1211,T106
AM,ZZ106,0,93,263,356,T106
AM,ZZ106,0,75,80,155,T106
AM,ZZ106,0,91,46,137,T106
AM,ZZ106,0,19,0,19,T106
MD,ZZ106,0,0,69,69,T106
MD,ZZ106,0,85,33,118,T106
MD,ZZ106,0,137,146,283,T106
MD,ZZ106,0,267,280,547,T106
MD,ZZ106,0,555,339,894,T106
AM,ZZ107,0,290,299,589,T107
AM,ZZ107,0,263,249,512,T107
AM,ZZ107,0,92,34,126,T107
AM,ZZ107,0,49,116,165,T107
MD,ZZ107,0,21,0,21,T107
MD,ZZ107,0,22,18,40,T107
MD,ZZ107,0,139,106,245,T107
MD,ZZ107,0,148,77,225,T107
MD,ZZ107,0,391,132,523,T107
AM,ZZ108,0,847,801,1648,T108
AM,ZZ108,0,94,70,164,T108
AM,ZZ108,0,68,46,114,T108
AM,ZZ108,0,0,50,50,T108
AM,ZZ108,0,46,0,46,T108
MD,ZZ108,0,14,33,47,T108
MD,ZZ108,0,45,23,68,T108
MD,ZZ108,0,59,125,184,T108
MD,ZZ108,0,127,28,155,T108
MD,ZZ108,0,427,394,821,T108
AM,ZZ109,0,600,398,998,T109
AM,ZZ109,0,78,0,78,T109
AM,ZZ109,0,17,0,17,T109
AM,ZZ109,0,21,0,21,T109
MD,ZZ109,0,16,0,16,T109
MD,ZZ109,0,33,19,52,T109
MD,ZZ109,0,86,0,86,T109
MD,ZZ109,0,141,118,259,T109
MD,ZZ109,0,605,173,778,T109
AM,ZZ110,0,678,522,1200,T110
AM,ZZ110,0,125,169,294,T110
AM,ZZ110,0,203,218,421,T110
AM,ZZ110,0,40,41,81,T110
MD,ZZ110,0,105,140,245,T110
MD,ZZ110,0,65,138,203,T110
MD,ZZ110,0,428,331,759,T110
AM,ZZ111,0,531,328,859,T111
AM,ZZ111,0,40,84,124,T111
AM,ZZ111,0,45,68,113,T111
MD,ZZ111,0,0,14,14,T111
MD,ZZ111,0,109,78,187,T111
MD,ZZ111,0,181,137,318,T111
MD,ZZ111,0,412,281,693,T111
AM,ZZ112,0,1031,555,1586,T112
AM,ZZ112,0,298,222,520,T112
AM,ZZ112,0,187,180,367,T112
AM,ZZ112,0,0,11,11,T112
AM,ZZ112,0,38,0,38,T112
MD,ZZ112,0,17,0,17,T112
MD,ZZ112,0,0,21,21,T112
MD,ZZ112,0,95,46,141,T112
MD,ZZ112,0,73,43,116,T112
MD,ZZ112,0,1008,505,1513,T112
AM,ZZ113,0,811,407,1218,T113
AM,ZZ113,0,21,67,88,T113
AM,ZZ113,0,0,26,26,T113
AM,ZZ113,0,0,32,32,T113
MD,ZZ113,0,0,21,21,T113
MD,ZZ113,0,29,19,48,T113
MD,ZZ113,0,72,145,217,T113
MD,ZZ113,0,400,357,757,T113
AM,ZZ115,0,37,18,55,T115
AM,ZZ115,0,0,22,22,T115
AM,ZZ115,0,41,24,65,T115
MD,ZZ115,0,0,14,14,T115
MD,ZZ115,0,43,14,57,T115
AM,ZZ116,0,2285,2095,4380,T116
AM,ZZ116,0,829,490,1319,T116
AM,ZZ116,0,153,230,383,T116
AM,ZZ116,0,0,59,59,T116
AM,ZZ116,0,0,23,23,T116
MD,ZZ116,0,54,24,78,T116
MD,ZZ116,0,281,272,553,T116
MD,ZZ116,0,646,417,1063,T116
MD,ZZ116,0,1877,1089,2966,T116
AM,ZZ117,0,47,77,124,T117
AM,ZZ117,0,0,44,44,T117
AM,ZZ117,0,123,170,293,T117
AM,ZZ117,0,61,76,137,T117
AM,ZZ117,0,25,0,25,T117
MD,ZZ117,0,62,0,62,T117
MD,ZZ117,0,0,19,19,T117
MD,ZZ117,0,64,18,82,T117
MD,ZZ117,0,35,77,112,T117
AM,ZZ120,0,169,223,392,T120
AM,ZZ120,0,0,57,57,T120
MD,ZZ120,0,0,61,61,T120
MD,ZZ120,0,22,22,44,T120
MD,ZZ120,0,114,49,163,T120
AM,ZZ122,0,501,273,774,T122
AM,ZZ122,0,89,0,89,T122
AM,ZZ122,0,171,98,269,T122
MD,ZZ122,0,96,0,96,T122
MD,ZZ122,0,53,0,53,T122
MD,ZZ122,0,326,175,501,T122
AM,ZZ123,0,329,138,467,T123
AM,ZZ123,0,141,105,246,T123
AM,ZZ123,0,178,81,259,T123
AM,ZZ123,0,0,17,17,T123
MD,ZZ123,0,35,0,35,T123
MD,ZZ123,0,128,41,169,T123
MD,ZZ123,0,298,25,323,T123
MD,ZZ123,0,449,202,651,T123
AM,ZZ124,0,192,81,273,T124
AM,ZZ124,0,174,86,260,T124
AM,ZZ124,0,193,217,410,T124
AM,ZZ124,0,108,22,130,T124
AM,ZZ124,0,17,0,17,T124
MD,ZZ124,0,15,29,44,T124
MD,ZZ124,0,107,53,160,T124
MD,ZZ124,0,241,42,283,T124
MD,ZZ124,0,89,73,162,T124
MD,ZZ124,0,232,96,328,T124
AM,ZZ125,0,445,336,781,T125
AM,ZZ125,0,46,0,46,T125
AM,ZZ125,0,48,29,77,T125
AM,ZZ125,0,18,0,18,T125
MD,ZZ125,0,17,0,17,T125
MD,ZZ125,0,26,55,81,T125
MD,ZZ125,0,0,16,16,T125
MD,ZZ125,0,144,19,163,T125
MD,ZZ125,0,417,201,618,T125
AM,ZZ126,0,162,301,463,T126
AM,ZZ126,0,67,24,91,T126
AM,ZZ126,0,46,0,46,T126
AM,ZZ126,0,23,0,23,T126
MD,ZZ126,0,35,0,35,T126
MD,ZZ126,0,16,20,36,T126
MD,ZZ126,0,249,18,267,T126
AM,ZZ127,0,334,44,378,T127
AM,ZZ127,0,0,32,32,T127
MD,ZZ127,0,29,0,29,T127
MD,ZZ127,0,88,49,137,T127
MD,ZZ127,0,197,115,312,T127
AM,ZZ129,0,1323,1039,2362,T129
AM,ZZ129,0,522,425,947,T129
AM,ZZ129,0,97,44,141,T129
AM,ZZ129,0,63,57,120,T129
AM,ZZ129,0,0,21,21,T129
MD,ZZ129,0,226,61,287,T129
MD,ZZ129,0,173,154,327,T129
MD,ZZ129,0,568,208,776,T129
MD,ZZ129,0,1416,676,2092,T129
AM,ZZ130,0,310,165,475,T130
AM,ZZ130,0,34,0,34,T130
AM,ZZ130,0,77,0,77,T130
MD,ZZ130,0,29,29,58,T130
MD,ZZ130,0,237,144,381,T130
AM,ZZ131,0,868,943,1811,T131
AM,ZZ131,0,203,17,220,T131
AM,ZZ131,0,0,27,27,T131
AM,ZZ131,0,45,18,63,T131
MD,ZZ131,0,22,0,22,T131
MD,ZZ131,0,60,90,150,T131
MD,ZZ131,0,60,0,60,T131
MD,ZZ131,0,172,193,365,T131
MD,ZZ131,0,590,293,883,T131
AM,ZZ132,0,251,246,497,T132
AM,ZZ132,0,54,103,157,T132
AM,ZZ132,0,15,44,59,T132
AM,ZZ132,0,0,71,71,T132
MD,ZZ132,0,0,10,10,T132
MD,ZZ132,0,21,0,21,T132
MD,ZZ132,0,30,33,63,T132
MD,ZZ132,0,133,283,416,T132
AM,ZZ133,0,1118,958,2076,T133
AM,ZZ133,0,226,91,317,T133
AM,ZZ133,0,130,0,130,T133
MD,ZZ133,0,31,0,31,T133
MD,ZZ133,0,30,33,63,T133
MD,ZZ133,0,166,116,282,T133
MD,ZZ133,0,371,250,621,T133
MD,ZZ133,0,1222,550,1772,T133
AM,ZZ134,0,493,551,1044,T134
AM,ZZ134,23,358,272,653,T134
AM,ZZ134,0,75,171,246,T134
AM,ZZ134,0,178,92,270,T134
AM,ZZ134,0,31,28,59,T134
MD,ZZ134,0,0,15,15,T134
MD,ZZ134,0,57,246,303,T134
MD,ZZ134,0,178,90,268,T134
MD,ZZ134,0,335,189,524,T134
MD,ZZ134,0,629,408,1037,T134
AM,ZZ135,0,200,186,386,T135
AM,ZZ135,0,25,0,25,T135
AM,ZZ135,0,38,18,56,T135
MD,ZZ135,0,0,15,15,T135
MD,ZZ135,0,47,17,64,T135
MD,ZZ135,0,67,17,84,T135
MD,ZZ135,0,148,103,251,T135
AM,ZZ139,0,193,38,231,T139
AM,ZZ139,0,141,62,203,T139
AM,ZZ139,0,0,19,19,T139
AM,ZZ139,0,24,0,24,T139
MD,ZZ139,0,0,34,34,T139
MD,ZZ139,0,21,0,21,T139
MD,ZZ139,0,0,31,31,T139
MD,ZZ139,0,166,146,312,T139
AM,ZZ141,0,49,94,143,T141
MD,ZZ141,0,15,0,15,T141
AM,ZZ142,0,93,41,134,T142
AM,ZZ143,0,80,82,162,T143
AM,ZZ144,0,269,328,597,T144
AM,ZZ144,0,37,0,37,T144
MD,ZZ144,0,16,0,16,T144
AM,ZZ145,0,150,22,172,T145
AM,ZZ160,0,166,209,375,T160
AM,ZZ160,0,60,49,109,T160
AM,ZZ160,0,49,53,102,T160
AM,ZZ160,0,0,16,16,T160
MD,ZZ160,0,0,17,17,T160
MD,ZZ160,0,35,0,35,T160
MD,ZZ160,0,35,19,54,T160
MD,ZZ160,0,26,12,38,T160
MD,ZZ160,0,231,87,318,T160
AM,ZZ161,0,534,348,882,T161
AM,ZZ161,0,79,40,119,T161
AM,ZZ161,0,0,22,22,T161
AM,ZZ161,0,0,20,20,T161
MD,ZZ161,0,17,0,17,T161
MD,ZZ161,0,81,0,81,T161
MD,ZZ161,0,129,53,182,T161
MD,ZZ161,0,267,73,340,T161
AM,ZZ162,0,40,37,77,T162
AM,ZZ162,0,21,0,21,T162
AM,ZZ162,0,91,0,91,T162
MD,ZZ162,0,15,0,15,T162
MD,ZZ162,0,15,0,15,T162
MD,ZZ162,0,61,0,61,T162
AM,ZZ165,0,748,608,1356,T165
AM,ZZ165,0,733,594,1327,T165
AM,ZZ165,0,220,83,303,T165
AM,ZZ165,0,0,43,43,T165
MD,ZZ165,0,0,33,33,T165
MD,ZZ165,0,234,148,382,T165
MD,ZZ165,0,486,209,695,T165
MD,ZZ165,0,854,375,1229,T165
AM,ZZ167,0,76,102,178,T167
AM,ZZ167,0,21,46,67,T167
AM,ZZ167,0,0,28,28,T167
AM,ZZ167,0,0,20,20,T167
MD,ZZ167,0,16,29,45,T167
MD,ZZ167,0,36,84,120,T167
AM,ZZ168,0,1059,449,1508,T168
AM,ZZ168,0,41,39,80,T168
AM,ZZ168,0,24,46,70,T168
MD,ZZ168,0,15,0,15,T168
MD,ZZ168,0,154,41,195,T168
MD,ZZ168,0,98,55,153,T168
MD,ZZ168,0,599,357,956,T168
AM,ZZ169,0,198,74,272,T169
AM,ZZ169,0,63,21,84,T169
AM,ZZ169,0,0,28,28,T169
MD,ZZ169,0,13,0,13,T169
MD,ZZ169,0,105,84,189,T169
AM,ZZ171,0,0,17,17,T171
AM,ZZ190,0,435,254,689,T190
AM,ZZ190,0,308,265,573,T190
AM,ZZ190,0,24,103,127,T190
AM,ZZ190,0,83,0,83,T190
MD,ZZ190,0,18,0,18,T190
MD,ZZ190,0,21,0,21,T190
MD,ZZ190,0,118,0,118,T190
MD,ZZ190,0,519,174,693,T190
MD,ZZ190,0,602,281,883,T190
AM,ZZ191,0,706,593,1299,T191
AM,ZZ191,0,488,653,1141,T191
AM,ZZ191,0,451,188,639,T191
AM,ZZ191,0,58,74,132,T191
MD,ZZ191,0,17,18,35,T191
MD,ZZ191,0,359,245,604,T191
MD,ZZ191,0,359,173,532,T191
MD,ZZ191,0,619,499,1118,T191
AM,ZZ192,0,62,70,132,T192
AM,ZZ192,0,82,17,99,T192
AM,ZZ192,0,153,93,246,T192
AM,ZZ192,0,62,24,86,T192
MD,ZZ192,0,52,0,52,T192
MD,ZZ192,0,54,78,132,T192
MD,ZZ192,0,93,83,176,T192
MD,ZZ192,0,135,101,236,T192
AM,ZZ196,0,281,473,754,T196
AM,ZZ196,0,984,625,1609,T196
AM,ZZ196,0,1046,866,1912,T196
AM,ZZ196,0,628,395,1023,T196
AM,ZZ196,0,172,65,237,T196
AM,ZZ196,0,34,33,67,T196
MD,ZZ196,0,52,68,120,T196
MD,ZZ196,0,440,600,1040,T196
MD,ZZ196,0,1071,878,1949,T196
MD,ZZ196,0,509,603,1112,T196
MD,ZZ196,0,1115,1433,2548,T196
AM,ZZ199,0,872,516,1388,T199
AM,ZZ199,0,497,406,903,T199
AM,ZZ199,0,251,74,325,T199
AM,ZZ199,0,130,0,130,T199
AM,ZZ199,0,0,17,17,T199
MD,ZZ199,0,0,28,28,T199
MD,ZZ199,0,0,32,32,T199
MD,ZZ199,0,92,78,170,T199
MD,ZZ199,0,612,336,948,T199
MD,ZZ199,0,792,483,1275,T199
AM,ZZ224,0,181,87,268,T224
AM,ZZ224,0,143,29,172,T224
AM,ZZ224,0,81,0,81,T224
AM,ZZ224,0,0,42,42,T224
MD,ZZ224,0,29,27,56,T224
MD,ZZ224,0,44,0,44,T224
MD,ZZ224,0,173,92,265,T224
AM,ZZ300,0,0,17,17,T300
MD,ZZ300,0,17,0,17,T300
AM,ZZ302,0,26,0,26,T302
MD,ZZ302,0,0,11,11,T302
MD,ZZ302,0,14,11,25,T302
AM,ZZ303,0,0,14,14,T303
MD,ZZ303,0,0,14,14,T303
MD,ZZ306,0,32,0,32,T306
AM,ZZ308,0,21,0,21,T308
AM,ZZ312,0,23,0,23,T312
AM,ZZ313,0,0,14,14,T313
MD,ZZ316,0,32,0,32,T316
AM,ZZ320,0,0,22,22,T320
AM,ZZ321,0,53,0,53,T321
AM,ZZ329,0,21,0,21,T329
MD,ZZ329,0,53,0,53,T329
MD,ZZ354,0,13,0,13,T354
MD,ZZ354,0,13,0,13,T354
MD,ZZ385,0,29,0,29,T385
MD,ZZ400,0,0,15,15,T400
MD,ZZ402,0,13,0,13,T402
MD,ZZ404,0,14,0,14,T404
MD,ZZ405,0,51,0,51,T405
AM,T501,0,3538,2808,6346,T501
AM,T501,0,604,852,1456,T501
AM,T501,0,554,347,901,T501
AM,T501,0,228,104,332,T501
AM,T501,0,67,29,96,T501
AM,T501,0,0,19,19,T501
MD,T501,0,60,22,82,T501
MD,T501,0,144,95,239,T501
MD,T501,0,270,258,528,T501
MD,T501,0,819,616,1435,T501
MD,T501,0,3944,3718,7662,T501
AM,T502,0,210,169,379,T502
AM,T502,0,23,18,41,T502
AM,T502,0,25,0,25,T502
MD,T502,0,21,0,21,T502
MD,T502,0,25,97,122,T502
MD,T502,0,174,93,267,T502
AM,T503,0,196,138,334,T503
AM,T503,0,50,0,50,T503
MD,T503,0,39,16,55,T503
AM,T504,0,5966,3834,9800,T504
AM,T504,0,1697,1203,2900,T504
AM,T504,0,1308,1104,2412,T504
AM,T504,0,619,418,1037,T504
AM,T504,0,0,96,96,T504
AM,T504,0,31,0,31,T504
MD,T504,0,29,0,29,T504
MD,T504,0,335,179,514,T504
MD,T504,0,676,805,1481,T504
MD,T504,0,1334,694,2028,T504
MD,T504,0,4474,3133,7607,T504
AM,T505,0,2489,2038,4527,T505
AM,T505,0,721,352,1073,T505
AM,T505,0,248,199,447,T505
AM,T505,0,70,51,121,T505
AM,T505,0,55,25,80,T505
MD,T505,0,17,130,147,T505
MD,T505,0,118,112,230,T505
MD,T505,0,247,200,447,T505
MD,T505,0,719,783,1502,T505
MD,T505,0,2734,2005,4739,T505
AM,T506,0,3086,2190,5276,T506
AM,T506,0,856,473,1329,T506
AM,T506,0,431,212,643,T506
AM,T506,0,99,82,181,T506
AM,T506,0,21,0,21,T506
MD,T506,0,14,11,25,T506
MD,T506,0,60,59,119,T506
MD,T506,0,492,352,844,T506
MD,T506,0,916,481,1397,T506
MD,T506,0,3682,2641,6323,T506
AM,T508,0,68,166,234,T508
AM,T508,0,0,30,30,T508
AM,T508,0,37,0,37,T508
AM,T508,0,31,0,31,T508
MD,T508,0,52,164,216,T508
AM,T509,0,1044,737,1781,T509
AM,T509,0,242,100,342,T509
AM,T509,0,141,23,164,T509
AM,T509,0,16,135,151,T509
AM,T509,0,0,27,27,T509
MD,T509,0,22,0,22,T509
MD,T509,0,193,93,286,T509
MD,T509,0,227,235,462,T509
MD,T509,0,1007,708,1715,T509
AM,T510,0,960,906,1866,T510
AM,T510,0,901,563,1464,T510
AM,T510,0,763,635,1398,T510
AM,T510,0,268,243,511,T510
AM,T510,0,57,0,57,T510
MD,T510,0,0,33,33,T510
MD,T510,0,242,61,303,T510
MD,T510,0,521,413,934,T510
MD,T510,0,939,663,1602,T510
MD,T510,0,1251,1029,2280,T510
AM,T511,0,1000,1248,2248,T511
AM,T511,0,351,338,689,T511
AM,T511,0,495,314,809,T511
AM,T511,0,189,73,262,T511
AM,T511,0,21,0,21,T511
AM,T511,0,18,0,18,T511
MD,T511,0,73,13,86,T511
MD,T511,0,249,271,520,T511
MD,T511,0,485,309,794,T511
MD,T511,0,1398,888,2286,T511
AM,T512,0,2422,1441,3863,T512
AM,T512,0,856,548,1404,T512
AM,T512,0,288,98,386,T512
AM,T512,0,245,41,286,T512
AM,T512,0,19,0,19,T512
MD,T512,0,0,19,19,T512
MD,T512,0,93,69,162,T512
MD,T512,0,213,124,337,T512
MD,T512,0,825,459,1284,T512
MD,T512,0,2046,1393,3439,T512
AM,T593,0,10168,8591,18759,T593
AM,T593,0,21255,15968,37223,T593
AM,T593,0,11197,9079,20276,T593
AM,T593,0,2805,1968,4773,T593
AM,T593,0,223,139,362,T593
AM,T593,0,32,21,53,T593
MD,T593,0,18,30,48,T593
MD,T593,0,143,40,183,T593
MD,T593,0,920,857,1777,T593
MD,T593,0,5372,4369,9741,T593
MD,T593,0,10820,8850,19670,T593
MD,T593,0,9997,8468,18465,T593
AM,T594,0,20884,18917,39801,T594
AM,T594,0,38601,31037,69638,T594
AM,T594,0,16610,12329,28939,T594
AM,T594,0,2953,2449,5402,T594
AM,T594,0,252,245,497,T594
MD,T594,0,28,45,73,T594
MD,T594,0,1424,1092,2516,T594
MD,T594,0,8604,7477,16081,T594
MD,T594,0,19324,14252,33576,T594
MD,T594,0,22450,18303,40753,T594
AM,T596,0,25466,21290,46756,T596
AM,T596,0,43577,32727,76304,T596
AM,T596,0,10607,8695,19302,T596
AM,T596,0,730,820,1550,T596
AM,T596,0,99,50,149,T596
MD,T596,0,30,60,90,T596
MD,T596,0,676,296,972,T596
MD,T596,0,6633,4390,11023,T596
MD,T596,0,31212,25515,56727,T596
MD,T596,0,20728,15567,36295,T596
AM,T597,0,2018,1415,3433,T597
AM,T597,0,4226,3511,7737,T597
AM,T597,0,723,732,1455,T597
AM,T597,0,0,49,49,T597
AM,T597,0,0,30,30,T597
MD,T597,0,27,0,27,T597
MD,T597,0,104,125,229,T597
MD,T597,0,1150,1041,2191,T597
MD,T597,0,2639,1992,4631,T597
MD,T597,0,1138,618,1756,T597
AM,T598,0,3182,2993,6175,T598
AM,T598,0,2797,2062,4859,T598
AM,T598,0,795,571,1366,T598
AM,T598,0,223,371,594,T598
AM,T598,0,23,0,23,T598
MD,T598,0,0,12,12,T598
MD,T598,0,281,177,458,T598
MD,T598,0,780,399,1179,T598
MD,T598,0,2079,1701,3780,T598
MD,T598,0,1841,1164,3005,T598
AM,TTC clientRoute unknown,0,0,22,22,TTC clientRoute unknown
AM,TTC Wheel Trans,0,822,592,1414,TTC Wheel Trans
AM,TTC Wheel Trans,0,22,0,22,TTC Wheel Trans
MD,TTC Wheel Trans,0,25,49,74,TTC Wheel Trans
MD,TTC Wheel Trans,0,3056,1704,4760,TTC Wheel Trans
AM,Via Rail,0,133,122,255,Via Rail
AM,Via Rail,0,38,0,38,Via Rail
MD,Via Rail,0,0,21,21,Via Rail
MD,Via Rail,0,175,130,305,Via Rail
AM,VZ00,0,2098,1771,3869,VZ00
AM,VZ00,0,707,597,1304,VZ00
AM,VZ00,0,28,67,95,VZ00
AM,VZ00,0,25,27,52,VZ00
MD,VZ00,0,23,21,44,VZ00
MD,VZ00,0,62,31,93,VZ00
MD,VZ00,0,154,28,182,VZ00
MD,VZ00,0,533,360,893,VZ00
MD,VZ00,0,1691,1512,3203,VZ00
AM,VZ01,0,675,516,1191,VZ01
AM,VZ01,0,341,346,687,VZ01
AM,VZ01,0,106,33,139,VZ01
MD,VZ01,0,34,0,34,VZ01
MD,VZ01,0,57,19,76,VZ01
MD,VZ01,0,100,20,120,VZ01
MD,VZ01,0,347,292,639,VZ01
MD,VZ01,0,573,557,1130,VZ01
AM,VZ02,0,52,30,82,VZ02
AM,VZ02,0,15,16,31,VZ02
AM,VZ02,0,22,24,46,VZ02
AM,VZ02,0,18,0,18,VZ02
MD,VZ02,0,0,21,21,VZ02
MD,VZ02,0,77,45,122,VZ02
AM,VZ03,0,149,369,518,VZ03
AM,VZ03,0,23,145,168,VZ03
MD,VZ03,0,31,20,51,VZ03
AM,VZ04,0,146,223,369,VZ04
AM,VZ04,0,144,107,251,VZ04
MD,VZ04,0,0,26,26,VZ04
MD,VZ04,0,125,27,152,VZ04
MD,VZ04,0,145,72,217,VZ04
AM,WA01,0,122,106,228,WA01
AM,WA01,0,0,19,19,WA01
MD,WA01,0,31,32,63,WA01
MD,WA01,0,240,125,365,WA01
AM,WA02,0,32,0,32,WA02
MD,WA02,0,13,0,13,WA02
MD,WA02,0,80,32,112,WA02
AM,WA03,0,88,143,231,WA03
MD,WA03,0,55,70,125,WA03
MD,WA03,0,100,121,221,WA03
AM,WA04,0,88,22,110,WA04
AM,WA04,0,44,17,61,WA04
MD,WA04,0,0,16,16,WA04
MD,WA04,0,96,102,198,WA04
AM,WA05,0,115,67,182,WA05
MD,WA05,0,66,27,93,WA05
MD,WA05,0,148,203,351,WA05
AM,WA06,0,63,57,120,WA06
AM,WA06,0,17,18,35,WA06
MD,WA06,0,34,48,82,WA06
MD,WA06,0,154,20,174,WA06
AM,WA07,0,862,512,1374,WA07
AM,WA07,0,668,555,1223,WA07
AM,WA07,0,39,0,39,WA07
MD,WA07,0,0,16,16,WA07
MD,WA07,0,341,356,697,WA07
MD,WA07,0,1753,1108,2861,WA07
AM,WA08,0,533,478,1011,WA08
AM,WA08,0,74,104,178,WA08
MD,WA08,0,31,0,31,WA08
MD,WA08,0,120,97,217,WA08
MD,WA08,0,554,655,1209,WA08
AM,WA09,0,206,317,523,WA09
AM,WA09,0,99,59,158,WA09
AM,WA09,0,17,0,17,WA09
MD,WA09,0,58,104,162,WA09
MD,WA09,0,289,348,637,WA09
AM,WA10,0,143,151,294,WA10
AM,WA10,0,76,32,108,WA10
AM,WA10,0,0,32,32,WA10
MD,WA10,0,31,0,31,WA10
MD,WA10,0,20,38,58,WA10
MD,WA10,0,259,151,410,WA10
AM,WA11,0,162,129,291,WA11
AM,WA11,0,34,87,121,WA11
MD,WA11,0,44,78,122,WA11
MD,WA11,0,188,149,337,WA11
AM,WA12,0,426,564,990,WA12
AM,WA12,0,133,90,223,WA12
AM,WA12,0,34,0,34,WA12
MD,WA12,0,181,108,289,WA12
MD,WA12,0,556,555,1111,WA12
AM,WA13,0,307,221,528,WA13
AM,WA13,0,13,0,13,WA13
MD,WA13,0,13,0,13,WA13
MD,WA13,0,256,206,462,WA13
AM,WA14,0,33,0,33,WA14
AM,WA14,0,22,20,42,WA14
AM,WA14,0,22,16,38,WA14
MD,WA14,0,17,13,30,WA14
MD,WA14,0,20,0,20,WA14
AM,WA15,0,81,73,154,WA15
AM,WA15,0,32,0,32,WA15
MD,WA15,0,17,0,17,WA15
MD,WA15,0,169,0,169,WA15
AM,WA16,0,88,57,145,WA16
AM,WA16,0,56,17,73,WA16
AM,WA16,0,0,22,22,WA16
MD,WA16,0,0,22,22,WA16
MD,WA16,0,32,96,128,WA16
MD,WA16,0,74,140,214,WA16
AM,WA17,0,77,53,130,WA17
MD,WA17,0,54,0,54,WA17
MD,WA17,0,67,38,105,WA17
AM,WA18,0,51,0,51,WA18
AM,WA18,0,32,0,32,WA18
MD,WA18,0,31,20,51,WA18
AM,WA19,0,89,97,186,WA19
AM,WA19,0,0,17,17,WA19
MD,WA19,0,19,42,61,WA19
MD,WA19,0,0,43,43,WA19
AM,WA20,0,110,42,152,WA20
AM,WA20,0,35,21,56,WA20
MD,WA20,0,80,21,101,WA20
MD,WA20,0,58,64,122,WA20
AM,WA201,0,251,234,485,WA201
AM,WA201,0,83,140,223,WA201
AM,WA201,0,0,66,66,WA201
MD,WA201,0,17,0,17,WA201
MD,WA201,0,34,123,157,WA201
MD,WA201,0,749,352,1101,WA201
AM,WA21,0,21,19,40,WA21
AM,WA21,0,18,0,18,WA21
MD,WA21,0,26,0,26,WA21
MD,WA21,0,16,16,32,WA21
MD,WA21,0,16,29,45,WA21
AM,WA22,0,356,293,649,WA22
AM,WA22,0,21,105,126,WA22
MD,WA22,0,85,57,142,WA22
MD,WA22,0,204,144,348,WA22
AM,WA23,0,178,52,230,WA23
AM,WA23,0,43,19,62,WA23
MD,WA23,0,18,32,50,WA23
MD,WA23,0,40,50,90,WA23
AM,WA24,0,124,161,285,WA24
AM,WA24,0,55,0,55,WA24
MD,WA24,0,74,65,139,WA24
MD,WA24,0,172,54,226,WA24
AM,WA25,0,248,81,329,WA25
AM,WA25,0,51,0,51,WA25
MD,WA25,0,13,32,45,WA25
MD,WA25,0,136,21,157,WA25
MD,WA25,0,182,93,275,WA25
AM,WA27,0,88,60,148,WA27
MD,WA27,0,21,11,32,WA27
MD,WA27,0,50,166,216,WA27
AM,WA29,0,60,116,176,WA29
AM,WA29,0,0,22,22,WA29
MD,WA29,0,47,17,64,WA29
MD,WA29,0,237,287,524,WA29
AM,WA31,0,20,87,107,WA31
AM,WA31,0,22,13,35,WA31
MD,WA31,0,0,92,92,WA31
AM,WA32,0,27,20,47,WA32
AM,WA32,0,0,34,34,WA32
AM,WA33,0,14,0,14,WA33
MD,WA33,0,0,34,34,WA33
AM,WA35,0,86,131,217,WA35
AM,WA35,0,0,21,21,WA35
MD,WA35,0,19,0,19,WA35
MD,WA35,0,47,0,47,WA35
MD,WA35,0,80,91,171,WA35
AM,WA51,0,119,162,281,WA51
AM,WA51,0,274,118,392,WA51
MD,WA51,0,379,120,499,WA51
MD,WA51,0,432,73,505,WA51
AM,WA52,0,81,108,189,WA52
AM,WA52,0,91,153,244,WA52
AM,WA52,0,32,0,32,WA52
MD,WA52,0,12,0,12,WA52
MD,WA52,0,46,0,46,WA52
MD,WA52,0,200,262,462,WA52
AM,WA53,0,141,68,209,WA53
AM,WA53,0,69,70,139,WA53
MD,WA53,0,12,45,57,WA53
MD,WA53,0,34,45,79,WA53
AM,WA54,0,47,23,70,WA54
MD,WA54,0,54,23,77,WA54
AM,WA55,0,83,28,111,WA55
MD,WA55,0,28,0,28,WA55
MD,WA55,0,21,21,42,WA55
MD,WA55,0,84,43,127,WA55
AM,WA56,0,0,17,17,WA56
AM,WA56,0,0,19,19,WA56
AM,WA56,0,21,0,21,WA56
MD,WA56,0,17,0,17,WA56
MD,WA56,0,36,0,36,WA56
AM,WA57,0,0,21,21,WA57
AM,WA57,0,23,0,23,WA57
MD,WA57,0,12,0,12,WA57
MD,WA57,0,37,12,49,WA57
AM,WA58,0,90,0,90,WA58
MD,WA58,0,24,0,24,WA58
MD,WA58,0,84,0,84,WA58
AM,WA59,0,77,0,77,WA59
AM,WA59,0,56,47,103,WA59
AM,WA59,0,0,17,17,WA59
MD,WA59,0,24,0,24,WA59
MD,WA59,0,41,64,105,WA59
AM,WA60,0,93,0,93,WA60
MD,WA60,0,58,0,58,WA60
MD,WA60,0,80,79,159,WA60
AM,WA61,0,28,110,138,WA61
AM,WA61,0,85,22,107,WA61
AM,WA61,0,28,28,56,WA61
MD,WA61,0,77,0,77,WA61
MD,WA61,0,105,28,133,WA61
AM,WA62,0,49,55,104,WA62
MD,WA62,0,28,28,56,WA62
MD,WA62,0,28,55,83,WA62
AM,WA63,0,100,60,160,WA63
MD,WA63,0,101,23,124,WA63
MD,WA63,0,167,17,184,WA63
AM,WA64,0,46,40,86,WA64
MD,WA64,0,0,17,17,WA64
MD,WA64,0,41,22,63,WA64
MD,WA64,0,91,0,91,WA64
AM,WA65,0,44,22,66,WA65
MD,WA65,0,22,22,44,WA65
MD,WA65,0,50,60,110,WA65
AM,WA66,0,0,66,66,WA66
MD,WA66,0,31,0,31,WA66
MD,WA66,0,0,66,66,WA66
AM,WA67,0,24,0,24,WA67
MD,WA67,0,54,30,84,WA67
AM,WA71,0,116,116,232,WA71
MD,WA71,0,41,0,41,WA71
MD,WA71,0,22,0,22,WA71
MD,WA71,0,84,50,134,WA71
AM,WA72,0,0,28,28,WA72
AM,WA73,0,0,20,20,WA73
MD,WA73,0,0,82,82,WA73
AM,WA75,0,77,0,77,WA75
MD,WA75,0,37,0,37,WA75
AM,WA90,0,425,355,780,WA90
AM,WA90,0,320,282,602,WA90
AM,WA90,0,28,0,28,WA90
MD,WA90,0,41,0,41,WA90
MD,WA90,0,303,229,532,WA90
MD,WA90,0,899,445,1344,WA90
AM,WA91,0,50,84,134,WA91
AM,WA91,0,81,112,193,WA91
MD,WA91,0,139,84,223,WA91
MD,WA91,0,125,296,421,WA91
AM,WA97,0,29,83,112,WA97
MD,WA97,0,81,100,181,WA97
AM,WA98,0,294,363,657,WA98
AM,WA98,0,58,64,122,WA98
MD,WA98,0,164,206,370,WA98
MD,WA99,0,45,32,77,WA99
AM,WE01,0,48,16,64,WE01
MD,WE01,0,42,0,42,WE01
AM,WE02,0,19,0,19,WE02
AM,WE02,0,23,0,23,WE02
MD,WE02,0,37,0,37,WE02
MD,WE02,0,18,18,36,WE02
AM,WE03,0,46,0,46,WE03
MD,WE03,0,46,0,46,WE03
MD,WE04,0,17,0,17,WE04
AM,WE05,0,61,0,61,WE05
AM,WE05,0,19,0,19,WE05
MD,WE05,0,26,0,26,WE05
MD,WE05,0,29,18,47,WE05
MD,WE05,0,126,44,170,WE05
AM,WE06,0,27,0,27,WE06
MD,WE06,0,26,0,26,WE06
MD,WE06,0,44,18,62,WE06
MD,WE06,0,209,37,246,WE06
AM,WE08,0,26,26,52,WE08
AM,WE08,0,27,0,27,WE08
MD,WE08,0,26,0,26,WE08
MD,WE08,0,75,79,154,WE08
AM,WE09,0,0,26,26,WE09
MD,WE09,0,123,0,123,WE09
MD,WE09,0,101,111,212,WE09
AM,WE50,0,0,30,30,WE50
AM,WE51,0,27,28,55,WE51
MD,WE51,0,28,28,56,WE51
AM,WE98,0,25,53,78,WE98
MD,WE98,0,77,110,187,WE98
AM,WE99,0,27,0,27,WE99
AM,XF98,0,46,26,72,XF98
MD,XF98,0,103,76,179,XF98
AM,Y001,0,0,32,32,Y001
AM,Y001,0,126,45,171,Y001
AM,Y001,0,23,0,23,Y001
MD,Y001,0,70,41,111,Y001
MD,Y001,0,120,32,152,Y001
AM,Y002,0,556,397,953,Y002
AM,Y002,0,207,37,244,Y002
AM,Y002,0,0,21,21,Y002
AM,Y002,0,53,15,68,Y002
MD,Y002,0,192,76,268,Y002
MD,Y002,0,239,159,398,Y002
AM,Y003,0,196,193,389,Y003
AM,Y003,0,45,20,65,Y003
AM,Y003,0,20,0,20,Y003
AM,Y003,0,18,0,18,Y003
MD,Y003,0,26,29,55,Y003
MD,Y003,0,239,99,338,Y003
AM,Y004,0,598,539,1137,Y004
AM,Y004,0,77,70,147,Y004
MD,Y004,0,58,18,76,Y004
MD,Y004,0,174,99,273,Y004
MD,Y004,0,546,150,696,Y004
AM,Y005,0,195,187,382,Y005
AM,Y005,0,20,0,20,Y005
MD,Y005,0,20,0,20,Y005
MD,Y005,0,26,0,26,Y005
MD,Y005,0,358,133,491,Y005
AM,Y007,0,108,69,177,Y007
AM,Y007,0,24,72,96,Y007
AM,Y007,0,26,0,26,Y007
MD,Y007,0,26,47,73,Y007
MD,Y007,0,0,26,26,Y007
MD,Y007,0,212,130,342,Y007
AM,Y008,0,146,75,221,Y008
AM,Y008,0,39,15,54,Y008
MD,Y008,0,0,20,20,Y008
MD,Y008,0,64,29,93,Y008
MD,Y008,0,68,42,110,Y008
AM,Y009,0,0,30,30,Y009
MD,Y009,0,0,20,20,Y009
AM,Y010,0,116,120,236,Y010
AM,Y010,0,51,0,51,Y010
MD,Y010,0,202,173,375,Y010
AM,Y011,0,20,0,20,Y011
MD,Y011,0,24,0,24,Y011
AM,Y012,0,95,24,119,Y012
AM,Y012,0,22,0,22,Y012
AM,Y012,0,42,0,42,Y012
MD,Y012,0,18,0,18,Y012
MD,Y012,0,46,24,70,Y012
AM,Y013,0,71,24,95,Y013
AM,Y013,0,0,39,39,Y013
MD,Y013,0,20,0,20,Y013
MD,Y013,0,0,24,24,Y013
MD,Y013,0,26,41,67,Y013
AM,Y015,0,69,22,91,Y015
AM,Y018,0,246,231,477,Y018
AM,Y018,0,20,60,80,Y018
MD,Y018,0,46,77,123,Y018
AM,Y020,0,324,254,578,Y020
AM,Y020,0,81,27,108,Y020
AM,Y020,0,28,0,28,Y020
AM,Y020,0,0,13,13,Y020
MD,Y020,0,15,0,15,Y020
MD,Y020,0,0,56,56,Y020
MD,Y020,0,24,79,103,Y020
MD,Y020,0,210,205,415,Y020
AM,Y022,0,126,95,221,Y022
AM,Y022,0,0,81,81,Y022
MD,Y022,0,49,0,49,Y022
MD,Y022,0,29,27,56,Y022
MD,Y022,0,123,60,183,Y022
AM,Y023,0,87,127,214,Y023
AM,Y023,0,0,27,27,Y023
MD,Y023,0,26,46,72,Y023
MD,Y023,0,156,26,182,Y023
AM,Y024,0,0,34,34,Y024
AM,Y024,0,0,17,17,Y024
AM,Y024,0,22,0,22,Y024
MD,Y024,0,0,18,18,Y024
AM,Y031,0,18,22,40,Y031
MD,Y031,0,22,18,40,Y031
AM,Y032,0,107,170,277,Y032
MD,Y032,0,22,45,67,Y032
AM,Y033,0,0,18,18,Y033
AM,Y033,0,0,35,35,Y033
MD,Y033,0,30,0,30,Y033
MD,Y033,0,0,30,30,Y033
AM,Y040,0,16,106,122,Y040
AM,Y040,0,31,0,31,Y040
MD,Y040,0,16,16,32,Y040
AM,Y041,0,76,39,115,Y041
MD,Y041,0,38,76,114,Y041
AM,Y042,0,58,0,58,Y042
MD,Y042,0,0,22,22,Y042
AM,Y044,0,38,33,71,Y044
AM,Y044,0,0,19,19,Y044
MD,Y044,0,52,19,71,Y044
AM,Y045,0,32,0,32,Y045
AM,Y050,0,14,0,14,Y050
MD,Y050,0,34,69,103,Y050
AM,Y051,0,20,41,61,Y051
MD,Y051,0,34,0,34,Y051
AM,Y052,0,0,33,33,Y052
MD,Y053,0,0,33,33,Y053
AM,Y054,0,91,74,165,Y054
AM,Y054,0,19,0,19,Y054
MD,Y054,0,58,17,75,Y054
AM,Y055,0,143,61,204,Y055
AM,Y055,0,41,19,60,Y055
AM,Y055,0,19,37,56,Y055
MD,Y055,0,37,98,135,Y055
MD,Y055,0,243,134,377,Y055
AM,Y056,0,41,49,90,Y056
AM,Y056,0,30,0,30,Y056
MD,Y056,0,22,49,71,Y056
AM,Y057,0,115,126,241,Y057
AM,Y057,0,0,19,19,Y057
MD,Y057,0,47,22,69,Y057
MD,Y057,0,178,99,277,Y057
AM,Y058,0,17,0,17,Y058
MD,Y058,0,33,0,33,Y058
AM,Y069,0,21,0,21,Y069
AM,Y077,0,164,292,456,Y077
AM,Y077,0,252,217,469,Y077
AM,Y077,0,31,20,51,Y077
AM,Y077,0,0,27,27,Y077
MD,Y077,0,22,0,22,Y077
MD,Y077,0,18,0,18,Y077
MD,Y077,0,156,190,346,Y077
MD,Y077,0,183,220,403,Y077
AM,Y081,0,56,90,146,Y081
AM,Y081,0,21,0,21,Y081
MD,Y081,0,0,23,23,Y081
MD,Y081,0,0,19,19,Y081
AM,Y082,0,46,66,112,Y082
MD,Y082,0,31,70,101,Y082
AM,Y083,0,175,121,296,Y083
AM,Y083,0,0,23,23,Y083
MD,Y083,0,23,0,23,Y083
MD,Y083,0,64,65,129,Y083
AM,Y084,0,0,20,20,Y084
MD,Y084,0,49,19,68,Y084
AM,Y085,0,534,442,976,Y085
AM,Y085,0,94,40,134,Y085
AM,Y085,0,42,47,89,Y085
AM,Y085,0,13,0,13,Y085
MD,Y085,0,48,16,64,Y085
MD,Y085,0,98,152,250,Y085
MD,Y085,0,436,420,856,Y085
AM,Y086,0,273,139,412,Y086
MD,Y086,0,69,123,192,Y086
AM,Y087,0,102,174,276,Y087
AM,Y087,0,21,0,21,Y087
MD,Y087,0,19,0,19,Y087
MD,Y087,0,134,47,181,Y087
AM,Y088,0,713,391,1104,Y088
AM,Y088,0,155,20,175,Y088
AM,Y088,0,11,0,11,Y088
AM,Y088,0,23,0,23,Y088
MD,Y088,0,0,28,28,Y088
MD,Y088,0,25,27,52,Y088
MD,Y088,0,244,83,327,Y088
MD,Y088,0,493,227,720,Y088
AM,Y090,0,204,209,413,Y090
AM,Y090,0,198,217,415,Y090
AM,Y090,0,24,43,67,Y090
AM,Y090,0,0,60,60,Y090
MD,Y090,0,0,22,22,Y090
MD,Y090,0,96,36,132,Y090
MD,Y090,0,220,302,522,Y090
AM,Y091,0,777,569,1346,Y091
AM,Y091,0,101,125,226,Y091
AM,Y091,0,34,0,34,Y091
MD,Y091,0,18,0,18,Y091
MD,Y091,0,165,25,190,Y091
MD,Y091,0,438,371,809,Y091
AM,Y098,0,67,62,129,Y098
AM,Y098,0,19,0,19,Y098
AM,Y098,0,19,0,19,Y098
MD,Y098,0,49,0,49,Y098
MD,Y098,0,135,59,194,Y098
AM,Y099,0,245,211,456,Y099
AM,Y099,0,144,106,250,Y099
AM,Y099,0,38,0,38,Y099
MD,Y099,0,0,31,31,Y099
MD,Y099,0,53,81,134,Y099
MD,Y099,0,342,88,430,Y099
AM,Y102,0,0,22,22,Y102
AM,Y201,0,72,0,72,Y201
AM,Y202,0,40,64,104,Y202
AM,Y222,0,18,22,40,Y222
AM,Y223,0,0,22,22,Y223
AM,Y240,0,0,19,19,Y240
AM,Y241,0,22,23,45,Y241
AM,Y243,0,0,50,50,Y243
AM,Y300,0,0,57,57,Y300
AM,Y300,0,35,29,64,Y300
MD,Y300,0,34,32,66,Y300
AM,Y301,0,21,51,72,Y301
AM,Y301,0,32,0,32,Y301
MD,Y301,0,21,0,21,Y301
AM,Y302,0,53,42,95,Y302
AM,Y303,0,140,52,192,Y303
AM,Y303,0,24,21,45,Y303
AM,Y304,0,42,24,66,Y304
AM,Y360,0,217,73,290,Y360
AM,Y360,0,0,26,26,Y360
MD,Y360,0,27,0,27,Y360
AM,Y400,0,0,21,21,Y400
MD,Y400,0,46,0,46,Y400
AM,Y408,0,0,22,22,Y408
AM,Y409,0,0,23,23,Y409
AM,Y410,0,0,43,43,Y410
MD,Y410,0,0,21,21,Y410
AM,Y411,0,21,0,21,Y411
MD,Y411,0,20,0,20,Y411
AM,Y413,0,21,0,21,Y413
AM,Y418,0,20,0,20,Y418
AM,Y422,0,0,99,99,Y422
AM,Y426,0,0,45,45,Y426
AM,Y440,0,0,21,21,Y440
MD,Y440,0,0,21,21,Y440
MD,Y443,0,22,0,22,Y443
AM,Y444,0,23,23,46,Y444
MD,Y444,0,0,23,23,Y444
MD,Y445,0,22,0,22,Y445
AM,Y446,0,22,0,22,Y446
MD,Y446,0,40,0,40,Y446
AM,Y449,0,59,39,98,Y449
AM,Y461,0,40,20,60,Y461
MD,Y461,0,20,0,20,Y461
AM,Y462,0,22,0,22,Y462
AM,Y463,0,40,0,40,Y463
MD,Y463,0,20,0,20,Y463
MD,Y464,0,0,22,22,Y464
MD,Y520,0,47,13,60,Y520
AM,Y521,0,0,17,17,Y521
MD,Y521,0,47,47,94,Y521
MD,Y522,0,0,32,32,Y522
AM,Y589,0,22,62,84,Y589
MD,Y589,0,78,16,94,Y589
AM,Y600,0,23,81,104,Y600
MD,Y600,0,204,100,304,Y600
AM,Y760,0,0,20,20,Y760
MD,Y760,0,0,20,20,Y760
AM,Y999,0,22,0,22,Y999
MD,Y999,0,28,0,28,Y999
