Time,Line,Unknown,Female,Male,Total
AM,BA10,0,67,92,159
AM,BA11,0,48,47,95
AM,BA12,0,29,20,49
AM,BA13,0,34,0,34
AM,BA14,0,48,0,48
AM,BA15,0,47,54,101
AM,BA16,0,0,25,25
AM,BA18,0,0,25,25
AM,BA20,0,0,34,34
AM,BA22,0,43,0,43
AM,BA24,0,57,20,77
AM,BA28,0,0,47,47
AM,BA30,0,169,57,226
AM,BA31,0,34,103,137
AM,BA32,0,23,0,23
AM,BA33,0,23,0,23
AM,BA34,0,54,124,178
AM,BA39,0,23,34,57
AM,BA41,0,57,34,91
AM,BA97,0,0,68,68
AM,BA98,0,34,34,68
AM,BR01,0,374,382,756
AM,BR02,0,447,167,614
AM,BR03,0,185,177,362
AM,BR04,0,676,452,1128
AM,BR05,0,766,476,1242
AM,BR07,0,419,390,809
AM,BR08,0,245,172,417
AM,BR09,0,197,146,343
AM,BR10,0,67,0,67
AM,BR101,0,21,0,21
AM,BR11,0,302,383,685
AM,BR12,0,122,21,143
AM,BR13,0,0,22,22
AM,BR14,0,331,286,617
AM,BR15,0,499,335,834
AM,BR16,0,49,21,70
AM,BR17,0,122,94,216
AM,BR18,0,416,304,720
AM,BR19,0,85,84,169
AM,BR21,0,23,25,48
AM,BR22,0,22,0,22
AM,BR23,0,387,273,660
AM,BR24,0,205,78,283
AM,BR25,0,52,0,52
AM,BR29,0,220,206,426
AM,BR30,0,350,140,490
AM,BR32,0,0,25,25
AM,BR33,0,25,0,25
AM,BR40,0,69,49,118
AM,BR50,0,165,166,331
AM,BR501,0,445,550,995
AM,BR502,0,299,175,474
AM,BR51,0,92,0,92
AM,BR52,0,236,149,385
AM,BR53,0,144,126,270
AM,BR54,0,52,23,75
AM,BR92,0,70,105,175
AM,BR97,0,218,146,364
AM,BR99,0,0,19,19
AM,BT01,0,59,21,80
AM,BT02,0,26,24,50
AM,BT04,0,203,151,354
AM,BT05,0,61,0,61
AM,BT06,0,26,0,26
AM,BT07,0,23,47,70
AM,BT08,0,0,66,66
AM,BT09,0,57,71,128
AM,BT97,0,21,42,63
AM,BT98,0,23,0,23
AM,BU01,0,83,92,175
AM,BU02,0,123,191,314
AM,BU03,0,100,23,123
AM,BU04,0,75,22,97
AM,BU05,0,87,38,125
AM,BU06,0,144,0,144
AM,BU10,0,232,204,436
AM,BU101,0,29,0,29
AM,BU11,0,22,34,56
AM,BU12,0,76,25,101
AM,BU15,0,75,83,158
AM,BU61,0,26,26,52
AM,BU62,0,0,50,50
AM,BU96,0,0,25,25
AM,CO03,0,0,11,11
AM,CO99,0,43,0,43
AM,D101,0,25,29,54
AM,D102,0,0,54,54
AM,D103,0,127,72,199
AM,D105,0,95,18,113
AM,D106,0,36,0,36
AM,D107,0,54,73,127
AM,D108,0,18,0,18
AM,D109,0,0,25,25
AM,D110,0,67,73,140
AM,D111,0,21,58,79
AM,D112,0,151,83,234
AM,D114,0,24,0,24
AM,D115,0,43,0,43
AM,D117,0,25,25,50
AM,D121,0,18,0,18
AM,D141,0,29,72,101
AM,D197,0,146,127,273
AM,D198,0,0,29,29
AM,D218,0,97,48,145
AM,D219,0,204,160,364
AM,D221,0,38,43,81
AM,D222,0,101,55,156
AM,D224,0,208,24,232
AM,D225,0,221,118,339
AM,D226,0,107,85,192
AM,D232,0,27,63,90
AM,D296,0,22,0,22
AM,D297,0,70,89,159
AM,D301,0,23,111,134
AM,D302,0,200,68,268
AM,D303,0,23,74,97
AM,D304,0,46,82,128
AM,D305,0,228,250,478
AM,D306,0,31,63,94
AM,D308,0,0,24,24
AM,D318,0,0,19,19
AM,D397,0,44,68,112
AM,D401,0,327,238,565
AM,D402,0,130,87,217
AM,D403,0,52,34,86
AM,D405,0,83,0,83
AM,D406,0,0,164,164
AM,D407,0,105,92,197
AM,D408,0,17,42,59
AM,D409,0,91,69,160
AM,D410,0,158,198,356
AM,D411,0,61,86,147
AM,D412,0,124,61,185
AM,D413,0,0,22,22
AM,D419,0,0,45,45
AM,D420,0,174,226,400
AM,D421,0,0,57,57
AM,D496,0,109,59,168
AM,D497,0,0,57,57
AM,D501,0,27,71,98
AM,D606,0,16,0,16
AM,D915,0,322,497,819
AM,D916,0,277,422,699
AM,D922,0,51,128,179
AM,D923,0,27,0,27
AM,D950,0,0,23,23
AM,FE99,0,0,26,26
AM,GB12,0,42,25,67
AM,GB15,0,140,147,287
AM,GB16,0,365,190,555
AM,GB19,0,328,204,532
AM,GB20,0,53,33,86
AM,GB21,0,442,479,921
AM,GB25,0,124,72,196
AM,GB27,0,115,258,373
AM,GB29,0,77,15,92
AM,GB31,0,126,52,178
AM,GB32,0,130,111,241
AM,GB33,0,22,22,44
AM,GB34,0,634,263,897
AM,GB37,0,67,39,106
AM,GB38,0,130,55,185
AM,GB40,0,17,17,34
AM,GB46,0,1153,1007,2160
AM,GB52,0,947,384,1331
AM,GB61,0,187,91,278
AM,GB65,0,193,27,220
AM,GB66,0,173,137,310
AM,GB69,0,38,0,38
AM,GB71,0,207,150,357
AM,GB81,0,101,94,195
AM,GB88,0,19,0,19
AM,GB90,0,95,240,335
AM,GB93,0,173,0,173
AM,GB94,0,759,601,1360
AM,GB95,0,265,125,390
AM,GB96,0,200,177,377
AM,GT01,0,10903,12355,23258
AM,GT02,0,7220,7595,14815
AM,GT03,0,5057,3684,8741
AM,GT05,0,4788,4551,9339
AM,GT06,28,2833,3285,6146
AM,GT07,0,4461,3886,8347
AM,GT09,0,10845,8570,19415
AM,GU01,0,29,29,58
AM,GU03,0,69,66,135
AM,GU06,0,20,71,91
AM,GU08,0,29,0,29
AM,GU10,0,91,49,140
AM,GU22,0,21,0,21
AM,GU23,0,19,48,67
AM,GU24,0,54,75,129
AM,GU31,0,0,94,94
AM,GU32,0,48,28,76
AM,GU33,0,87,61,148
AM,GU34,0,0,22,22
AM,GU35,0,23,0,23
AM,GU37,0,51,0,51
AM,GU39,0,13,19,32
AM,GU40,0,91,19,110
AM,GU41,0,19,68,87
AM,GU43,0,18,48,66
AM,GU44,0,22,18,40
AM,GU50,0,28,0,28
AM,GU51,0,19,0,19
AM,GU70,0,30,30,60
AM,GU71,0,0,40,40
AM,GU76,0,30,0,30
AM,GU97,0,0,32,32
AM,GU99,0,95,106,201
AM,HA01,0,1327,864,2191
AM,HA02,0,698,700,1398
AM,HA03,0,558,135,693
AM,HA04,0,462,262,724
AM,HA05,0,1105,809,1914
AM,HA06,0,106,128,234
AM,HA07,0,21,22,43
AM,HA08,0,78,16,94
AM,HA10,0,562,455,1017
AM,HA11,0,184,251,435
AM,HA12,0,28,22,50
AM,HA18,0,0,35,35
AM,HA20,0,24,85,109
AM,HA21,0,378,213,591
AM,HA22,0,338,190,528
AM,HA23,0,269,230,499
AM,HA24,0,367,176,543
AM,HA25,0,185,174,359
AM,HA26,0,552,442,994
AM,HA27,0,189,123,312
AM,HA33,0,257,183,440
AM,HA34,0,198,102,300
AM,HA35,0,357,250,607
AM,HA41,0,627,439,1066
AM,HA43,0,122,150,272
AM,HA44,0,139,183,322
AM,HA51,0,134,195,329
AM,HA52,0,374,45,419
AM,HA55,0,127,120,247
AM,HA56,0,21,0,21
AM,HA58,0,70,0,70
AM,HA90,0,81,68,149
AM,HA91,0,22,25,47
AM,HA93,0,17,0,17
AM,HA98,0,71,96,167
AM,HA99,0,0,18,18
AM,LI02,0,25,0,25
AM,Midland Transit,0,20,28,48
AM,ML01,0,0,70,70
AM,ML02,0,86,0,86
AM,ML03,0,27,0,27
AM,ML04,0,24,70,94
AM,ML05,0,27,93,120
AM,ML06,0,27,49,76
AM,ML07,0,0,27,27
AM,ML90,0,24,0,24
AM,MS01,0,1151,623,1774
AM,MS03,0,911,652,1563
AM,MS04,0,106,182,288
AM,MS05,0,202,254,456
AM,MS06,0,239,112,351
AM,MS07,0,185,172,357
AM,MS08,0,200,223,423
AM,MS09,0,209,277,486
AM,MS10,0,415,333,748
AM,MS101,0,153,168,321
AM,MS103,0,324,169,493
AM,MS107,0,23,59,82
AM,MS11,0,180,193,373
AM,MS110,0,174,329,503
AM,MS12,0,0,30,30
AM,MS13,0,486,387,873
AM,MS14,0,0,40,40
AM,MS15,0,60,31,91
AM,MS16,0,76,110,186
AM,MS17,0,17,23,40
AM,MS18,0,69,28,97
AM,MS19,0,1651,1261,2912
AM,MS20,0,396,328,724
AM,MS22,0,200,26,226
AM,MS23,0,204,183,387
AM,MS26,0,951,700,1651
AM,MS27,0,18,28,46
AM,MS28,0,330,90,420
AM,MS29,0,94,152,246
AM,MS303,0,20,0,20
AM,MS31,0,109,0,109
AM,MS317,0,0,49,49
AM,MS32,0,0,80,80
AM,MS320,0,19,0,19
AM,MS321,0,43,0,43
AM,MS33,0,45,29,74
AM,MS34,0,290,281,571
AM,MS35,0,384,343,727
AM,MS36,0,92,98,190
AM,MS38,0,421,313,734
AM,MS39,0,149,116,265
AM,MS41,0,139,173,312
AM,MS42,0,275,194,469
AM,MS44,0,187,78,265
AM,MS45,0,284,338,622
AM,MS46,0,109,0,109
AM,MS47,0,99,104,203
AM,MS48,0,137,116,253
AM,MS49,0,83,137,220
AM,MS50,0,19,0,19
AM,MS51,0,68,119,187
AM,MS53,0,119,77,196
AM,MS57,0,90,111,201
AM,MS61,0,525,378,903
AM,MS62,0,19,0,19
AM,MS64,0,47,89,136
AM,MS65,0,41,0,41
AM,MS66,0,332,188,520
AM,MS67,0,0,71,71
AM,MS68,0,148,109,257
AM,MS70,0,0,17,17
AM,MS76,0,93,50,143
AM,MS89,0,334,214,548
AM,MS90,0,100,166,266
AM,MS91,0,19,98,117
AM,MS97,0,0,63,63
AM,MS98,0,46,28,74
AM,MS99,0,0,23,23
AM,MS990,0,54,0,54
AM,NI01,0,18,25,43
AM,NI03,0,0,26,26
AM,NI04,0,0,24,24
AM,NI05,0,25,49,74
AM,NI06,0,24,45,69
AM,NI11,0,0,26,26
AM,NI12,0,25,18,43
AM,NI14,0,72,18,90
AM,NI15,0,26,25,51
AM,NI30,0,0,26,26
AM,NI31,0,80,75,155
AM,NI98,0,25,0,25
AM,NI99,0,0,30,30
AM,NR70,0,0,31,31
AM,NR75,0,0,32,32
AM,OA01,0,72,100,172
AM,OA02,0,22,0,22
AM,OA03,0,61,40,101
AM,OA04,0,0,61,61
AM,OA05,0,0,24,24
AM,OA06,0,81,71,152
AM,OA11,0,0,22,22
AM,OA13,0,262,108,370
AM,OA14,0,295,172,467
AM,OA15,0,74,49,123
AM,OA17,0,88,32,120
AM,OA18,0,25,33,58
AM,OA19,0,54,199,253
AM,OA20,0,104,114,218
AM,OA21,0,64,118,182
AM,OA22,0,25,57,82
AM,OA24,0,205,66,271
AM,OA25,0,0,18,18
AM,OA26,0,51,14,65
AM,OA28,0,59,37,96
AM,OA33,0,20,25,45
AM,OA83,0,36,18,54
AM,OA97,0,22,24,46
AM,OA99,0,0,33,33
AM,OR02,0,0,26,26
AM,OR03,0,26,0,26
AM,OR04,0,26,0,26
AM,OR05,0,51,0,51
AM,OV01,0,39,19,58
AM,PE01,0,119,111,230
AM,PE02,0,53,46,99
AM,PE04,0,65,19,84
AM,PE05,0,101,47,148
AM,PE06,0,75,48,123
AM,PE07,0,210,0,210
AM,PE08,0,75,76,151
AM,PE09,0,66,0,66
AM,PE10,0,19,0,19
AM,PE11,0,81,120,201
AM,PE90,0,46,0,46
AM,Rockwood Transit,0,0,17,17
AM,SC01,0,17,52,69
AM,SC02,0,30,0,30
AM,SC03,0,89,60,149
AM,SC04,0,25,41,66
AM,SC05,0,79,0,79
AM,SC06,0,27,27,54
AM,SC07,0,116,123,239
AM,SC08,0,90,69,159
AM,SC09,0,17,35,52
AM,SC10,0,0,30,30
AM,SC11,0,50,48,98
AM,SC12,0,23,28,51
AM,SC123,0,0,31,31
AM,SC15,0,23,45,68
AM,SC16,0,58,102,160
AM,SC17,0,45,75,120
AM,SC18,0,0,23,23
AM,SC20,0,60,31,91
AM,SC21,0,0,31,31
AM,SC25,0,27,28,55
AM,SC46,0,25,0,25
AM,SC51,0,75,79,154
AM,SC56,0,47,0,47
AM,SC65,0,52,0,52
AM,SC66,0,30,27,57
AM,SC68,0,30,30,60
AM,SC72,0,28,0,28
AM,SN97,0,32,0,32
AM,T005,0,334,258,592
AM,T006,0,354,318,672
AM,T007,0,2171,1342,3513
AM,T008,0,322,269,591
AM,T009,0,366,538,904
AM,T010,0,311,112,423
AM,T011,0,530,508,1038
AM,T012,0,763,959,1722
AM,T014,0,183,120,303
AM,T015,0,184,92,276
AM,T016,0,943,561,1504
AM,T017,0,1356,639,1995
AM,T020,0,591,391,982
AM,T021,23,1162,864,2049
AM,T022,0,449,297,746
AM,T023,0,711,542,1253
AM,T024,0,2086,1566,3652
AM,T025,0,4027,2476,6503
AM,T026,0,435,284,719
AM,T028,0,281,145,426
AM,T029,0,3007,2441,5448
AM,T030,0,331,120,451
AM,T031,0,371,114,485
AM,T032,0,4355,3012,7367
AM,T033,0,89,56,145
AM,T034,0,2639,1681,4320
AM,T035,0,3953,2823,6776
AM,T036,0,3469,2871,6340
AM,T037,0,1614,1327,2941
AM,T038,0,572,242,814
AM,T039,0,3325,2521,5846
AM,T040,0,340,260,600
AM,T041,0,1700,1507,3207
AM,T042,0,1192,897,2089
AM,T043,0,1463,968,2431
AM,T044,0,403,432,835
AM,T045,0,2168,1708,3876
AM,T046,0,891,469,1360
AM,T047,0,1123,531,1654
AM,T048,0,245,236,481
AM,T049,0,603,386,989
AM,T050,0,573,331,904
AM,T051,0,369,481,850
AM,T052,0,2217,1615,3832
AM,T053,0,2544,2208,4752
AM,T054,0,3000,2406,5406
AM,T055,0,107,99,206
AM,T056,0,221,323,544
AM,T057,0,1053,1207,2260
AM,T058,0,544,482,1026
AM,T059,0,276,204,480
AM,T060,0,2126,1876,4002
AM,T061,0,383,255,638
AM,T062,0,294,353,647
AM,T063,0,2093,1128,3221
AM,T064,0,341,315,656
AM,T065,0,295,367,662
AM,T066,0,718,488,1206
AM,T067,0,796,444,1240
AM,T068,0,1486,1042,2528
AM,T069,0,727,451,1178
AM,T070,0,499,446,945
AM,T071,0,685,335,1020
AM,T072,0,501,529,1030
AM,T073,0,884,851,1735
AM,T074,0,215,208,423
AM,T075,0,359,227,586
AM,T076,0,951,630,1581
AM,T077,0,375,126,501
AM,T078,0,221,106,327
AM,T079,0,849,545,1394
AM,T080,0,97,39,136
AM,T081,0,450,583,1033
AM,T082,0,70,46,116
AM,T083,0,156,229,385
AM,T084,0,1842,1200,3042
AM,T085,0,3225,2158,5383
AM,T086,0,1831,1093,2924
AM,T087,0,1070,635,1705
AM,T088,0,274,461,735
AM,T089,0,1566,906,2472
AM,T090,0,723,641,1364
AM,T091,0,399,625,1024
AM,T092,0,126,103,229
AM,T094,0,757,761,1518
AM,T095,0,3225,1849,5074
AM,T096,22,2199,1494,3715
AM,T097,0,504,216,720
AM,T098,0,362,268,630
AM,T100,0,1267,1148,2415
AM,T102,0,1929,1798,3727
AM,T103,0,72,109,181
AM,T104,0,235,312,547
AM,T105,0,473,501,974
AM,T106,0,807,404,1211
AM,T107,0,290,299,589
AM,T108,0,847,801,1648
AM,T109,0,600,398,998
AM,T110,0,678,522,1200
AM,T111,0,531,328,859
AM,T112,0,1031,555,1586
AM,T113,0,811,407,1218
AM,T115,0,37,18,55
AM,T116,0,2285,2095,4380
AM,T117,0,47,77,124
AM,T120,0,169,223,392
AM,T122,0,501,273,774
AM,T123,0,329,138,467
AM,T124,0,192,81,273
AM,T125,0,445,336,781
AM,T126,0,162,301,463
AM,T127,0,334,44,378
AM,T129,0,1323,1039,2362
AM,T130,0,310,165,475
AM,T131,0,868,943,1811
AM,T132,0,251,246,497
AM,T133,0,1118,958,2076
AM,T134,0,493,551,1044
AM,T135,0,200,186,386
AM,T139,0,193,38,231
AM,T141,0,49,94,143
AM,T142,0,93,41,134
AM,T143,0,80,82,162
AM,T144,0,269,328,597
AM,T145,0,150,22,172
AM,T160,0,166,209,375
AM,T161,0,534,348,882
AM,T162,0,40,37,77
AM,T165,0,748,608,1356
AM,T167,0,76,102,178
AM,T168,0,1059,449,1508
AM,T169,0,198,74,272
AM,T171,0,0,17,17
AM,T190,0,435,254,689
AM,T191,0,706,593,1299
AM,T192,0,62,70,132
AM,T196,0,281,473,754
AM,T199,0,872,516,1388
AM,T224,0,181,87,268
AM,T300,0,0,17,17
AM,T302,0,26,0,26
AM,T312,0,23,0,23
AM,T313,0,0,14,14
AM,T321,0,53,0,53
AM,T329,0,21,0,21
AM,TTC Wheel Trans,0,822,592,1414
AM,T501,0,3538,2808,6346
AM,T502,0,210,169,379
AM,T503,0,196,138,334
AM,T504,0,5966,3834,9800
AM,T505,0,2489,2038,4527
AM,T506,0,3086,2190,5276
AM,T508,0,68,166,234
AM,T509,0,1044,737,1781
AM,T510,0,960,906,1866
AM,T511,0,1000,1248,2248
AM,T512,0,2422,1441,3863
AM,T593,0,10168,8591,18759
AM,T594,0,20884,18917,39801
AM,T596,0,25466,21290,46756
AM,T597,0,2018,1415,3433
AM,T598,0,3182,2993,6175
AM,TTC clientRoute unknown,0,0,22,22
AM,WA01,0,122,106,228
AM,WA02,0,32,0,32
AM,WA03,0,88,143,231
AM,WA04,0,88,22,110
AM,WA05,0,115,67,182
AM,WA06,0,63,57,120
AM,WA07,0,862,512,1374
AM,WA08,0,533,478,1011
AM,WA09,0,206,317,523
AM,WA10,0,143,151,294
AM,WA11,0,162,129,291
AM,WA12,0,426,564,990
AM,WA13,0,307,221,528
AM,WA14,0,33,0,33
AM,WA15,0,81,73,154
AM,WA16,0,88,57,145
AM,WA17,0,77,53,130
AM,WA18,0,51,0,51
AM,WA19,0,89,97,186
AM,WA20,0,110,42,152
AM,WA201,0,251,234,485
AM,WA21,0,21,19,40
AM,WA22,0,356,293,649
AM,WA23,0,178,52,230
AM,WA24,0,124,161,285
AM,WA25,0,248,81,329
AM,WA27,0,88,60,148
AM,WA29,0,60,116,176
AM,WA31,0,20,87,107
AM,WA35,0,86,131,217
AM,WA51,0,119,162,281
AM,WA52,0,81,108,189
AM,WA53,0,141,68,209
AM,WA54,0,47,23,70
AM,WA55,0,83,28,111
AM,WA56,0,0,17,17
AM,WA57,0,0,21,21
AM,WA58,0,90,0,90
AM,WA59,0,77,0,77
AM,WA60,0,93,0,93
AM,WA61,0,28,110,138
AM,WA62,0,49,55,104
AM,WA63,0,100,60,160
AM,WA64,0,46,40,86
AM,WA65,0,44,22,66
AM,WA66,0,0,66,66
AM,WA67,0,24,0,24
AM,WA71,0,116,116,232
AM,WA73,0,0,20,20
AM,WA75,0,77,0,77
AM,WA90,0,425,355,780
AM,WA91,0,50,84,134
AM,WA97,0,29,83,112
AM,WA98,0,294,363,657
AM,WE01,0,48,16,64
AM,WE02,0,19,0,19
AM,WE03,0,46,0,46
AM,WE05,0,61,0,61
AM,WE06,0,27,0,27
AM,WE08,0,26,26,52
AM,WE09,0,0,26,26
AM,WE51,0,27,28,55
AM,WE98,0,25,53,78
AM,WE99,0,27,0,27
AM,Canada Coach,0,73,91,164
AM,XF98,0,46,26,72
AM,Island Ferry,0,239,399,638
AM,Grey Coach,0,26,83,109
AM,Grey Hound,0,404,138,542
AM,Via Rail,0,133,122,255
AM,Erindale School,0,0,29,29
AM,Private Bus,0,1532,1096,2628
AM,Y001,0,0,32,32
AM,Y002,0,556,397,953
AM,Y003,0,196,193,389
AM,Y004,0,598,539,1137
AM,Y005,0,195,187,382
AM,Y007,0,108,69,177
AM,Y008,0,146,75,221
AM,Y009,0,0,30,30
AM,Y010,0,116,120,236
AM,Y011,0,20,0,20
AM,Y012,0,95,24,119
AM,Y013,0,71,24,95
AM,Y015,0,69,22,91
AM,Y018,0,246,231,477
AM,Y020,0,324,254,578
AM,Y022,0,126,95,221
AM,Y023,0,87,127,214
AM,Y024,0,0,34,34
AM,Y031,0,18,22,40
AM,Y032,0,107,170,277
AM,Y033,0,0,18,18
AM,Y040,0,16,106,122
AM,Y041,0,76,39,115
AM,Y042,0,58,0,58
AM,Y044,0,38,33,71
AM,Y045,0,32,0,32
AM,Y050,0,14,0,14
AM,Y051,0,20,41,61
AM,Y052,0,0,33,33
AM,Y054,0,91,74,165
AM,Y055,0,143,61,204
AM,Y056,0,41,49,90
AM,Y057,0,115,126,241
AM,Y058,0,17,0,17
AM,Y069,0,21,0,21
AM,Y077,0,164,292,456
AM,Y081,0,56,90,146
AM,Y082,0,46,66,112
AM,Y083,0,175,121,296
AM,Y084,0,0,20,20
AM,Y085,0,534,442,976
AM,Y086,0,273,139,412
AM,Y087,0,102,174,276
AM,Y088,0,713,391,1104
AM,Y090,0,204,209,413
AM,Y091,0,777,569,1346
AM,Y098,0,67,62,129
AM,Y099,0,245,211,456
AM,Y102,0,0,22,22
AM,Y201,0,72,0,72
AM,Y202,0,40,64,104
AM,Y222,0,18,22,40
AM,Y223,0,0,22,22
AM,Y240,0,0,19,19
AM,Y241,0,22,23,45
AM,Y243,0,0,50,50
AM,Y300,0,0,57,57
AM,Y301,0,21,51,72
AM,Y302,0,53,42,95
AM,Y303,0,140,52,192
AM,Y304,0,42,24,66
AM,Y360,0,217,73,290
AM,Y400,0,0,21,21
AM,Y408,0,0,22,22
AM,Y409,0,0,23,23
AM,Y410,0,0,43,43
AM,Y411,0,21,0,21
AM,Y413,0,21,0,21
AM,Y418,0,20,0,20
AM,Y422,0,0,99,99
AM,Y426,0,0,45,45
AM,Y440,0,0,21,21
AM,Y444,0,23,23,46
AM,Y446,0,22,0,22
AM,Y449,0,59,39,98
AM,Y461,0,40,20,60
AM,Y462,0,22,0,22
AM,Y463,0,40,0,40
AM,Y521,0,0,17,17
AM,Y589,0,22,62,84
AM,Y600,0,23,81,104
AM,Y760,0,0,20,20
AM,Y900,0,2098,1771,3869
AM,Y901,0,675,516,1191
AM,Y902,0,52,30,82
AM,Y903,0,149,369,518
AM,Y904,0,146,223,369
AM,Y999,0,22,0,22
AM,Not Used,28,135395,118298,253721
AM,BA11,0,34,78,112
AM,BA16,0,34,67,101
AM,BA18,0,47,47,94
AM,BA20,0,34,34,68
AM,BA24,0,25,0,25
AM,BA30,0,25,0,25
AM,BA31,0,0,57,57
AM,BA33,0,47,0,47
AM,BA34,0,34,0,34
AM,BA41,0,0,49,49
AM,BR01,0,227,86,313
AM,BR02,0,99,74,173
AM,BR03,0,101,0,101
AM,BR04,0,90,91,181
AM,BR05,0,114,150,264
AM,BR07,0,147,79,226
AM,BR08,0,23,0,23
AM,BR09,0,22,31,53
AM,BR10,0,0,25,25
AM,BR101,0,23,28,51
AM,BR11,0,1017,716,1733
AM,BR12,0,23,0,23
AM,BR14,0,96,72,168
AM,BR15,0,202,159,361
AM,BR16,0,28,27,55
AM,BR18,0,205,95,300
AM,BR21,0,24,64,88
AM,BR23,0,94,0,94
AM,BR24,0,0,22,22
AM,BR29,0,53,113,166
AM,BR30,0,50,71,121
AM,BR40,0,45,0,45
AM,BR50,0,0,23,23
AM,BR501,0,789,419,1208
AM,BR502,0,259,276,535
AM,BR51,0,74,0,74
AM,BR511,0,0,28,28
AM,BR52,0,84,28,112
AM,BR53,0,23,28,51
AM,BR97,0,45,22,67
AM,BT01,0,0,24,24
AM,BT04,0,59,0,59
AM,BT05,0,0,19,19
AM,BT07,0,26,43,69
AM,BT08,0,19,0,19
AM,BT09,0,40,21,61
AM,BU01,0,68,86,154
AM,BU02,0,79,25,104
AM,BU03,0,0,34,34
AM,BU04,0,14,0,14
AM,BU08,0,77,0,77
AM,BU10,0,46,66,112
AM,BU101,0,0,56,56
AM,BU11,0,0,49,49
AM,BU12,0,0,22,22
AM,BU21,0,50,0,50
AM,D101,0,29,0,29
AM,D232,0,22,24,46
AM,D302,0,9,14,23
AM,D304,0,23,46,69
AM,D305,0,0,37,37
AM,D306,0,0,51,51
AM,D401,0,168,168,336
AM,D402,0,37,45,82
AM,D406,0,20,0,20
AM,D407,0,23,0,23
AM,D408,0,44,0,44
AM,D409,0,14,44,58
AM,D410,0,0,59,59
AM,D412,0,24,59,83
AM,D413,0,34,0,34
AM,D419,0,0,31,31
AM,D420,0,0,57,57
AM,D915,0,181,31,212
AM,D916,0,62,103,165
AM,D922,0,18,26,44
AM,D923,0,18,90,108
AM,GB15,0,205,76,281
AM,GB16,0,140,56,196
AM,GB19,0,76,100,176
AM,GB20,0,27,32,59
AM,GB21,0,169,45,214
AM,GB25,0,0,29,29
AM,GB27,0,0,79,79
AM,GB29,0,85,0,85
AM,GB31,0,52,0,52
AM,GB32,0,51,28,79
AM,GB34,0,257,28,285
AM,GB40,0,0,30,30
AM,GB46,0,612,562,1174
AM,GB52,0,262,360,622
AM,GB61,0,0,28,28
AM,GB66,0,60,0,60
AM,GB71,0,41,0,41
AM,GB81,0,0,19,19
AM,GB93,0,0,33,33
AM,GB94,0,316,378,694
AM,GB95,0,86,15,101
AM,GB96,0,41,0,41
AM,GT01,0,1294,1645,2939
AM,GT02,0,694,1046,1740
AM,GT03,0,574,648,1222
AM,GT05,0,111,91,202
AM,GT06,0,265,336,601
AM,GT07,0,380,341,721
AM,GT09,0,1484,1469,2953
AM,GU03,0,0,11,11
AM,GU07,0,0,17,17
AM,GU08,0,20,30,50
AM,GU09,0,0,30,30
AM,GU22,0,0,19,19
AM,GU23,0,0,11,11
AM,GU32,0,13,56,69
AM,GU35,0,51,0,51
AM,GU41,0,18,0,18
AM,GU51,0,42,0,42
AM,GU52,0,29,29,58
AM,GU99,0,28,0,28
AM,HA01,0,360,151,511
AM,HA02,0,192,246,438
AM,HA04,0,251,131,382
AM,HA05,0,334,203,537
AM,HA06,0,56,23,79
AM,HA07,0,58,0,58
AM,HA10,0,319,361,680
AM,HA11,0,38,48,86
AM,HA16,0,28,0,28
AM,HA21,0,115,96,211
AM,HA22,0,71,78,149
AM,HA23,0,68,67,135
AM,HA24,0,25,0,25
AM,HA25,0,74,0,74
AM,HA26,0,55,0,55
AM,HA27,0,208,259,467
AM,HA33,0,27,72,99
AM,HA34,0,102,46,148
AM,HA35,0,213,138,351
AM,HA41,0,262,298,560
AM,HA43,0,23,46,69
AM,HA44,0,72,12,84
AM,HA51,0,306,152,458
AM,HA52,0,24,23,47
AM,HA55,0,113,90,203
AM,HA58,0,0,44,44
AM,ML01,0,17,0,17
AM,MS01,0,691,287,978
AM,MS03,0,154,149,303
AM,MS04,0,58,0,58
AM,MS05,0,293,229,522
AM,MS06,0,22,0,22
AM,MS07,0,111,130,241
AM,MS08,0,43,0,43
AM,MS09,0,46,0,46
AM,MS10,0,40,22,62
AM,MS101,0,70,184,254
AM,MS103,0,98,101,199
AM,MS107,0,190,253,443
AM,MS11,0,99,48,147
AM,MS110,0,704,426,1130
AM,MS13,0,101,16,117
AM,MS14,0,0,62,62
AM,MS15,0,52,22,74
AM,MS18,0,40,46,86
AM,MS19,0,726,363,1089
AM,MS20,0,72,50,122
AM,MS21,0,38,0,38
AM,MS22,0,99,55,154
AM,MS23,0,39,49,88
AM,MS26,0,388,320,708
AM,MS27,0,47,0,47
AM,MS28,0,41,130,171
AM,MS29,0,49,0,49
AM,MS34,0,60,39,99
AM,MS35,0,164,76,240
AM,MS36,0,0,22,22
AM,MS38,0,60,56,116
AM,MS39,0,85,104,189
AM,MS41,0,21,42,63
AM,MS42,0,210,191,401
AM,MS44,0,113,143,256
AM,MS45,0,57,17,74
AM,MS46,0,18,0,18
AM,MS48,0,77,50,127
AM,MS50,0,0,21,21
AM,MS51,0,403,323,726
AM,MS53,0,187,29,216
AM,MS57,0,57,20,77
AM,MS61,0,100,211,311
AM,MS62,0,0,28,28
AM,MS66,0,193,169,362
AM,MS70,0,58,0,58
AM,MS76,0,64,40,104
AM,MS82,0,18,79,97
AM,MS89,0,52,80,132
AM,MS90,0,105,32,137
AM,MS97,0,0,23,23
AM,NI06,0,0,18,18
AM,NI10,0,24,24,48
AM,NI14,0,25,26,51
AM,NR55,0,0,32,32
AM,OA01,0,119,155,274
AM,OA04,0,42,34,76
AM,OA06,0,37,0,37
AM,OA10,0,80,0,80
AM,OA11,0,0,44,44
AM,OA13,0,20,0,20
AM,OA14,0,76,23,99
AM,OA15,0,0,23,23
AM,OA24,0,101,49,150
AM,OA26,0,20,0,20
AM,OA32,0,32,32,64
AM,OR02,0,26,0,26
AM,OR04,0,25,0,25
AM,PE01,0,39,0,39
AM,PE02,0,54,0,54
AM,PE04,0,48,76,124
AM,PE05,0,12,0,12
AM,PE06,0,26,0,26
AM,PE07,0,0,93,93
AM,PE08,0,0,10,10
AM,PE09,0,0,28,28
AM,PE12,0,46,19,65
AM,PE82,0,26,0,26
AM,PE90,0,48,0,48
AM,SC02,0,0,22,22
AM,SC03,0,0,28,28
AM,SC05,0,25,0,25
AM,SC06,0,23,47,70
AM,SC10,0,39,0,39
AM,SC11,0,30,30,60
AM,SC12,0,19,0,19
AM,SC15,0,30,0,30
AM,SC16,0,105,134,239
AM,SC17,0,0,46,46
AM,SC18,0,23,23,46
AM,SC25,0,90,71,161
AM,SC46,0,0,30,30
AM,SC52,0,28,0,28
AM,T005,0,60,75,135
AM,T006,0,809,298,1107
AM,T007,0,753,326,1079
AM,T008,0,56,0,56
AM,T009,0,110,42,152
AM,T010,0,24,0,24
AM,T011,0,470,102,572
AM,T012,0,125,276,401
AM,T014,0,22,0,22
AM,T015,0,64,122,186
AM,T016,0,137,101,238
AM,T017,0,400,288,688
AM,T020,0,108,0,108
AM,T021,0,266,282,548
AM,T022,0,59,65,124
AM,T023,0,24,0,24
AM,T024,0,834,274,1108
AM,T025,0,1367,992,2359
AM,T026,0,56,52,108
AM,T028,0,79,0,79
AM,T029,0,1095,671,1766
AM,T030,0,18,54,72
AM,T031,0,23,16,39
AM,T032,0,1403,1279,2682
AM,T033,0,23,40,63
AM,T034,0,1326,919,2245
AM,T035,0,871,799,1670
AM,T036,0,1512,1296,2808
AM,T037,0,463,267,730
AM,T038,0,254,118,372
AM,T039,0,1298,866,2164
AM,T040,0,42,0,42
AM,T041,22,678,887,1587
AM,T042,0,542,206,748
AM,T043,0,544,238,782
AM,T044,0,585,388,973
AM,T045,0,475,532,1007
AM,T046,0,272,305,577
AM,T047,0,264,86,350
AM,T048,0,21,44,65
AM,T049,0,85,90,175
AM,T050,0,84,47,131
AM,T051,0,120,116,236
AM,T052,0,1174,700,1874
AM,T053,0,498,799,1297
AM,T054,0,979,671,1650
AM,T056,0,172,121,293
AM,T057,0,630,710,1340
AM,T058,0,631,346,977
AM,T059,0,0,176,176
AM,T060,0,1364,932,2296
AM,T061,0,160,87,247
AM,T062,0,123,70,193
AM,T063,0,324,267,591
AM,T064,0,143,109,252
AM,T065,0,13,48,61
AM,T066,0,15,0,15
AM,T067,0,141,56,197
AM,T068,0,719,479,1198
AM,T069,0,78,92,170
AM,T070,0,167,180,347
AM,T071,0,49,73,122
AM,T072,0,111,59,170
AM,T073,0,279,256,535
AM,T074,0,47,24,71
AM,T075,0,157,10,167
AM,T076,0,560,296,856
AM,T077,0,15,0,15
AM,T079,0,82,37,119
AM,T080,0,66,83,149
AM,T081,0,37,0,37
AM,T083,0,79,17,96
AM,T084,0,929,678,1607
AM,T085,0,980,265,1245
AM,T086,0,393,192,585
AM,T087,0,162,38,200
AM,T088,0,72,0,72
AM,T089,0,268,98,366
AM,T090,0,42,0,42
AM,T091,0,113,23,136
AM,T092,0,22,19,41
AM,T094,0,180,136,316
AM,T095,0,1587,1124,2711
AM,T096,0,1357,783,2140
AM,T097,0,28,13,41
AM,T098,0,0,66,66
AM,T100,0,223,134,357
AM,T102,0,642,705,1347
AM,T104,0,99,22,121
AM,T105,0,122,321,443
AM,T106,0,93,263,356
AM,T107,0,263,249,512
AM,T108,0,94,70,164
AM,T109,0,78,0,78
AM,T110,0,125,169,294
AM,T111,0,40,84,124
AM,T112,0,298,222,520
AM,T113,0,21,67,88
AM,T115,0,0,22,22
AM,T116,0,829,490,1319
AM,T117,0,0,44,44
AM,T122,0,89,0,89
AM,T123,0,141,105,246
AM,T124,0,174,86,260
AM,T125,0,46,0,46
AM,T126,0,67,24,91
AM,T127,0,0,32,32
AM,T129,0,522,425,947
AM,T130,0,34,0,34
AM,T131,0,203,17,220
AM,T132,0,54,103,157
AM,T133,0,226,91,317
AM,T134,23,358,272,653
AM,T135,0,25,0,25
AM,T139,0,141,62,203
AM,T144,0,37,0,37
AM,T160,0,60,49,109
AM,T161,0,79,40,119
AM,T165,0,733,594,1327
AM,T167,0,21,46,67
AM,T168,0,41,39,80
AM,T169,0,63,21,84
AM,T190,0,308,265,573
AM,T191,0,488,653,1141
AM,T192,0,82,17,99
AM,T196,0,984,625,1609
AM,T199,0,497,406,903
AM,T224,0,143,29,172
AM,T303,0,0,14,14
AM,T308,0,21,0,21
AM,T320,0,0,22,22
AM,TTC Wheel Trans,0,22,0,22
AM,T501,0,604,852,1456
AM,T502,0,23,18,41
AM,T503,0,50,0,50
AM,T504,0,1697,1203,2900
AM,T505,0,721,352,1073
AM,T506,0,856,473,1329
AM,T508,0,0,30,30
AM,T509,0,242,100,342
AM,T510,0,901,563,1464
AM,T511,0,351,338,689
AM,T512,0,856,548,1404
AM,T593,0,21255,15968,37223
AM,T594,0,38601,31037,69638
AM,T596,0,43577,32727,76304
AM,T597,0,4226,3511,7737
AM,T598,0,2797,2062,4859
AM,WA01,0,0,19,19
AM,WA04,0,44,17,61
AM,WA06,0,17,18,35
AM,WA07,0,668,555,1223
AM,WA08,0,74,104,178
AM,WA09,0,99,59,158
AM,WA10,0,76,32,108
AM,WA11,0,34,87,121
AM,WA12,0,133,90,223
AM,WA13,0,13,0,13
AM,WA14,0,22,20,42
AM,WA15,0,32,0,32
AM,WA16,0,56,17,73
AM,WA18,0,32,0,32
AM,WA19,0,0,17,17
AM,WA20,0,35,21,56
AM,WA201,0,83,140,223
AM,WA21,0,18,0,18
AM,WA22,0,21,105,126
AM,WA23,0,43,19,62
AM,WA24,0,55,0,55
AM,WA25,0,51,0,51
AM,WA29,0,0,22,22
AM,WA31,0,22,13,35
AM,WA32,0,27,20,47
AM,WA33,0,14,0,14
AM,WA51,0,274,118,392
AM,WA52,0,91,153,244
AM,WA53,0,69,70,139
AM,WA56,0,0,19,19
AM,WA57,0,23,0,23
AM,WA59,0,56,47,103
AM,WA61,0,85,22,107
AM,WA90,0,320,282,602
AM,WA91,0,81,112,193
AM,WA98,0,58,64,122
AM,WE02,0,23,0,23
AM,WE05,0,19,0,19
AM,WE08,0,27,0,27
AM,Canada Coach,0,0,16,16
AM,Island Ferry,0,0,27,27
AM,Grey Hound,0,35,0,35
AM,Via Rail,0,38,0,38
AM,Private Bus,0,358,139,497
AM,Y001,0,126,45,171
AM,Y002,0,207,37,244
AM,Y003,0,45,20,65
AM,Y004,0,77,70,147
AM,Y005,0,20,0,20
AM,Y007,0,24,72,96
AM,Y008,0,39,15,54
AM,Y010,0,51,0,51
AM,Y012,0,22,0,22
AM,Y018,0,20,60,80
AM,Y020,0,81,27,108
AM,Y022,0,0,81,81
AM,Y023,0,0,27,27
AM,Y033,0,0,35,35
AM,Y044,0,0,19,19
AM,Y054,0,19,0,19
AM,Y055,0,41,19,60
AM,Y056,0,30,0,30
AM,Y057,0,0,19,19
AM,Y077,0,252,217,469
AM,Y083,0,0,23,23
AM,Y085,0,94,40,134
AM,Y088,0,155,20,175
AM,Y090,0,198,217,415
AM,Y091,0,101,125,226
AM,Y098,0,19,0,19
AM,Y099,0,144,106,250
AM,Y303,0,24,21,45
AM,Y360,0,0,26,26
AM,Y900,0,707,597,1304
AM,Y901,0,341,346,687
AM,Y902,0,15,16,31
AM,Y903,0,23,145,168
AM,Y904,0,144,107,251
AM,Not Used,50,255185,211302,466537
AM,BR01,0,0,45,45
AM,BR03,0,0,28,28
AM,BR04,0,0,27,27
AM,BR05,0,0,23,23
AM,BR07,0,78,0,78
AM,BR10,0,68,0,68
AM,BR101,0,22,30,52
AM,BR11,0,133,55,188
AM,BR14,0,0,68,68
AM,BR15,0,73,0,73
AM,BR16,0,24,0,24
AM,BR18,0,44,0,44
AM,BR19,0,40,0,40
AM,BR40,0,0,27,27
AM,BR501,0,22,22,44
AM,BR502,0,65,0,65
AM,BR51,0,23,0,23
AM,BR53,0,27,0,27
AM,BU06,0,23,0,23
AM,BU11,0,22,0,22
AM,BU12,0,13,0,13
AM,D226,0,18,0,18
AM,D302,0,28,0,28
AM,D401,0,0,31,31
AM,D915,0,0,59,59
AM,D922,0,31,0,31
AM,GB12,0,0,22,22
AM,GB15,0,0,65,65
AM,GB16,0,0,56,56
AM,GB19,0,27,0,27
AM,GB21,0,28,0,28
AM,GB31,0,21,0,21
AM,GB33,0,14,0,14
AM,GB34,0,73,88,161
AM,GB46,0,117,68,185
AM,GB52,0,115,82,197
AM,GB65,0,15,0,15
AM,GB93,0,0,30,30
AM,GB94,0,34,61,95
AM,GB96,0,0,32,32
AM,GT01,0,163,60,223
AM,GT02,0,0,109,109
AM,GT03,0,76,51,127
AM,GT07,0,0,21,21
AM,GT09,0,70,44,114
AM,GU32,0,85,0,85
AM,GU33,0,51,0,51
AM,HA01,0,22,18,40
AM,HA02,0,20,28,48
AM,HA10,0,22,79,101
AM,HA35,0,56,131,187
AM,HA41,0,0,26,26
AM,HA51,0,0,23,23
AM,HA55,0,0,24,24
AM,HA91,0,0,19,19
AM,MS01,0,206,207,413
AM,MS03,0,45,24,69
AM,MS05,0,55,83,138
AM,MS07,0,0,66,66
AM,MS101,0,37,33,70
AM,MS103,0,45,56,101
AM,MS107,0,29,0,29
AM,MS11,0,23,55,78
AM,MS110,0,89,156,245
AM,MS14,0,20,0,20
AM,MS15,0,0,22,22
AM,MS17,0,0,16,16
AM,MS19,0,62,19,81
AM,MS20,0,18,0,18
AM,MS22,0,108,74,182
AM,MS23,0,41,0,41
AM,MS26,0,102,30,132
AM,MS27,0,59,0,59
AM,MS30,0,23,0,23
AM,MS35,0,86,69,155
AM,MS36,0,0,13,13
AM,MS38,0,19,57,76
AM,MS39,0,0,22,22
AM,MS42,0,24,22,46
AM,MS43,0,22,0,22
AM,MS45,0,29,0,29
AM,MS50,0,0,34,34
AM,MS51,0,197,39,236
AM,MS53,0,71,35,106
AM,MS57,0,23,0,23
AM,MS61,0,22,0,22
AM,MS66,0,0,58,58
AM,MS68,0,17,0,17
AM,MS70,0,16,24,40
AM,MS76,0,49,22,71
AM,MS82,0,77,21,98
AM,MS89,0,50,23,73
AM,MS90,0,16,0,16
AM,NI31,0,25,26,51
AM,OA01,0,28,0,28
AM,OA11,0,61,0,61
AM,OA17,0,21,0,21
AM,OA24,0,58,53,111
AM,SC20,0,17,0,17
AM,SN97,0,30,0,30
AM,T005,0,22,0,22
AM,T006,0,835,210,1045
AM,T007,0,335,320,655
AM,T008,0,48,0,48
AM,T009,0,19,42,61
AM,T011,0,326,164,490
AM,T012,0,139,237,376
AM,T014,0,13,0,13
AM,T015,0,71,83,154
AM,T016,0,30,41,71
AM,T017,0,245,157,402
AM,T020,0,124,0,124
AM,T021,0,63,23,86
AM,T022,0,140,51,191
AM,T023,0,28,13,41
AM,T024,0,322,308,630
AM,T025,0,409,345,754
AM,T026,0,37,30,67
AM,T028,0,76,0,76
AM,T029,0,510,555,1065
AM,T030,0,52,0,52
AM,T031,0,36,0,36
AM,T032,0,300,227,527
AM,T033,0,22,18,40
AM,T034,0,725,486,1211
AM,T035,0,485,117,602
AM,T036,0,381,254,635
AM,T037,0,238,196,434
AM,T038,0,154,29,183
AM,T039,0,184,169,353
AM,T040,0,28,0,28
AM,T041,0,392,151,543
AM,T042,0,49,82,131
AM,T043,0,219,281,500
AM,T044,0,505,560,1065
AM,T045,0,330,185,515
AM,T046,0,20,38,58
AM,T047,0,285,63,348
AM,T048,0,34,22,56
AM,T049,0,19,18,37
AM,T050,0,0,58,58
AM,T051,0,21,0,21
AM,T052,0,515,270,785
AM,T053,0,175,196,371
AM,T054,0,302,122,424
AM,T056,0,46,85,131
AM,T057,0,139,186,325
AM,T058,0,132,105,237
AM,T059,22,0,13,35
AM,T060,0,310,266,576
AM,T061,0,88,51,139
AM,T062,0,56,0,56
AM,T063,0,244,232,476
AM,T064,0,146,43,189
AM,T065,0,46,68,114
AM,T066,0,19,91,110
AM,T067,0,97,18,115
AM,T068,0,416,389,805
AM,T069,0,0,92,92
AM,T070,0,195,125,320
AM,T071,0,173,66,239
AM,T072,0,99,88,187
AM,T073,0,181,24,205
AM,T074,0,50,0,50
AM,T075,0,118,230,348
AM,T076,0,394,304,698
AM,T077,0,43,0,43
AM,T078,0,15,0,15
AM,T079,0,112,21,133
AM,T080,0,43,24,67
AM,T081,0,17,0,17
AM,T083,0,19,55,74
AM,T084,0,191,85,276
AM,T085,0,213,120,333
AM,T086,0,113,109,222
AM,T087,0,66,0,66
AM,T088,0,38,42,80
AM,T089,0,106,89,195
AM,T090,0,33,53,86
AM,T091,0,119,41,160
AM,T092,0,54,0,54
AM,T094,0,168,76,244
AM,T095,0,529,257,786
AM,T096,0,377,205,582
AM,T097,0,49,0,49
AM,T098,0,34,0,34
AM,T100,0,329,126,455
AM,T102,0,288,69,357
AM,T103,0,0,16,16
AM,T104,0,17,31,48
AM,T105,0,124,173,297
AM,T106,0,75,80,155
AM,T107,0,92,34,126
AM,T108,0,68,46,114
AM,T109,0,17,0,17
AM,T110,0,203,218,421
AM,T111,0,45,68,113
AM,T112,0,187,180,367
AM,T113,0,0,26,26
AM,T115,0,41,24,65
AM,T116,0,153,230,383
AM,T117,0,123,170,293
AM,T120,0,0,57,57
AM,T122,0,171,98,269
AM,T123,0,178,81,259
AM,T124,0,193,217,410
AM,T125,0,48,29,77
AM,T126,0,46,0,46
AM,T129,0,97,44,141
AM,T130,0,77,0,77
AM,T131,0,0,27,27
AM,T132,0,15,44,59
AM,T133,0,130,0,130
AM,T134,0,75,171,246
AM,T135,0,38,18,56
AM,T139,0,0,19,19
AM,T160,0,49,53,102
AM,T161,0,0,22,22
AM,T162,0,21,0,21
AM,T165,0,220,83,303
AM,T167,0,0,28,28
AM,T168,0,24,46,70
AM,T190,0,24,103,127
AM,T191,0,451,188,639
AM,T192,0,153,93,246
AM,T196,0,1046,866,1912
AM,T199,0,251,74,325
AM,T224,0,81,0,81
AM,T501,0,554,347,901
AM,T502,0,25,0,25
AM,T504,0,1308,1104,2412
AM,T505,0,248,199,447
AM,T506,0,431,212,643
AM,T508,0,37,0,37
AM,T509,0,141,23,164
AM,T510,0,763,635,1398
AM,T511,0,495,314,809
AM,T512,0,288,98,386
AM,T593,0,11197,9079,20276
AM,T594,0,16610,12329,28939
AM,T596,0,10607,8695,19302
AM,T597,0,723,732,1455
AM,T598,0,795,571,1366
AM,WA07,0,39,0,39
AM,WA09,0,17,0,17
AM,WA10,0,0,32,32
AM,WA12,0,34,0,34
AM,WA14,0,22,16,38
AM,WA16,0,0,22,22
AM,WA201,0,0,66,66
AM,WA32,0,0,34,34
AM,WA35,0,0,21,21
AM,WA52,0,32,0,32
AM,WA56,0,21,0,21
AM,WA59,0,0,17,17
AM,WA61,0,28,28,56
AM,WA72,0,0,28,28
AM,WA90,0,28,0,28
AM,WE50,0,0,30,30
AM,Island Ferry,0,61,0,61
AM,Grey Hound,0,0,52,52
AM,Erindale School,0,0,74,74
AM,Private Bus,0,139,194,333
AM,Y001,0,23,0,23
AM,Y002,0,0,21,21
AM,Y003,0,20,0,20
AM,Y007,0,26,0,26
AM,Y013,0,0,39,39
AM,Y020,0,28,0,28
AM,Y024,0,0,17,17
AM,Y040,0,31,0,31
AM,Y055,0,19,37,56
AM,Y077,0,31,20,51
AM,Y081,0,21,0,21
AM,Y085,0,42,47,89
AM,Y087,0,21,0,21
AM,Y088,0,11,0,11
AM,Y090,0,24,43,67
AM,Y091,0,34,0,34
AM,Y098,0,19,0,19
AM,Y099,0,38,0,38
AM,Y300,0,35,29,64
AM,Y301,0,32,0,32
AM,Y900,0,28,67,95
AM,Y901,0,106,33,139
AM,Y902,0,22,24,46
AM,Not Used,73,308854,252070,560997
AM,BR03,0,29,0,29
AM,BR04,0,0,27,27
AM,BR07,0,29,0,29
AM,BR11,0,23,0,23
AM,BR18,0,22,0,22
AM,BR502,0,28,0,28
AM,D420,0,0,61,61
AM,GB15,0,21,0,21
AM,GB21,0,0,21,21
AM,GB46,0,0,28,28
AM,GB52,0,0,32,32
AM,GB93,0,0,34,34
AM,GT01,0,0,22,22
AM,GT03,0,28,0,28
AM,GT09,0,17,0,17
AM,HA01,0,0,32,32
AM,HA55,0,0,28,28
AM,MS01,0,0,24,24
AM,MS05,0,14,0,14
AM,MS07,0,0,33,33
AM,MS101,0,27,19,46
AM,MS110,0,0,28,28
AM,MS12,0,31,0,31
AM,MS13,0,0,24,24
AM,MS15,0,0,22,22
AM,MS17,0,17,0,17
AM,MS19,0,20,21,41
AM,MS27,0,0,12,12
AM,MS35,0,70,0,70
AM,MS38,0,34,0,34
AM,MS42,0,0,17,17
AM,MS44,0,0,26,26
AM,MS47,0,0,17,17
AM,MS61,0,23,0,23
AM,MS82,0,15,0,15
AM,OA01,0,45,0,45
AM,T005,0,35,0,35
AM,T006,0,304,17,321
AM,T007,0,30,17,47
AM,T008,0,24,0,24
AM,T011,0,40,36,76
AM,T012,0,16,38,54
AM,T014,0,28,0,28
AM,T017,0,0,21,21
AM,T020,0,0,19,19
AM,T021,0,38,0,38
AM,T023,0,24,0,24
AM,T024,0,32,24,56
AM,T025,0,159,138,297
AM,T029,0,107,32,139
AM,T030,0,18,0,18
AM,T031,0,0,12,12
AM,T032,0,149,21,170
AM,T034,0,76,92,168
AM,T035,0,32,33,65
AM,T036,0,82,10,92
AM,T037,0,29,25,54
AM,T038,0,0,23,23
AM,T039,0,149,110,259
AM,T040,0,0,32,32
AM,T041,0,56,0,56
AM,T042,0,40,0,40
AM,T043,0,0,77,77
AM,T044,0,162,56,218
AM,T045,0,42,22,64
AM,T046,0,0,33,33
AM,T047,0,101,49,150
AM,T048,0,41,0,41
AM,T051,0,80,0,80
AM,T052,0,221,101,322
AM,T053,0,36,34,70
AM,T054,0,160,53,213
AM,T056,0,0,22,22
AM,T057,0,0,95,95
AM,T058,0,18,23,41
AM,T059,0,0,21,21
AM,T060,0,110,79,189
AM,T061,0,90,16,106
AM,T063,0,47,53,100
AM,T066,0,21,0,21
AM,T068,0,76,54,130
AM,T069,0,0,33,33
AM,T070,0,99,35,134
AM,T072,0,64,16,80
AM,T074,0,50,23,73
AM,T075,0,0,21,21
AM,T076,0,49,22,71
AM,T079,0,0,20,20
AM,T080,0,17,23,40
AM,T081,0,0,30,30
AM,T082,0,39,0,39
AM,T083,0,0,38,38
AM,T084,0,143,32,175
AM,T085,0,149,172,321
AM,T086,0,50,61,111
AM,T087,0,0,19,19
AM,T089,0,33,0,33
AM,T090,0,40,0,40
AM,T091,0,47,0,47
AM,T092,0,52,0,52
AM,T094,0,54,0,54
AM,T095,0,84,21,105
AM,T096,0,104,153,257
AM,T097,0,24,0,24
AM,T100,0,19,24,43
AM,T102,0,99,0,99
AM,T104,0,17,0,17
AM,T105,0,47,113,160
AM,T106,0,91,46,137
AM,T107,0,49,116,165
AM,T108,0,0,50,50
AM,T109,0,21,0,21
AM,T110,0,40,41,81
AM,T112,0,0,11,11
AM,T113,0,0,32,32
AM,T116,0,0,59,59
AM,T117,0,61,76,137
AM,T123,0,0,17,17
AM,T124,0,108,22,130
AM,T125,0,18,0,18
AM,T126,0,23,0,23
AM,T129,0,63,57,120
AM,T131,0,45,18,63
AM,T132,0,0,71,71
AM,T134,0,178,92,270
AM,T139,0,24,0,24
AM,T160,0,0,16,16
AM,T161,0,0,20,20
AM,T162,0,91,0,91
AM,T165,0,0,43,43
AM,T167,0,0,20,20
AM,T190,0,83,0,83
AM,T191,0,58,74,132
AM,T192,0,62,24,86
AM,T196,0,628,395,1023
AM,T199,0,130,0,130
AM,T224,0,0,42,42
AM,T501,0,228,104,332
AM,T504,0,619,418,1037
AM,T505,0,70,51,121
AM,T506,0,99,82,181
AM,T508,0,31,0,31
AM,T509,0,16,135,151
AM,T510,0,268,243,511
AM,T511,0,189,73,262
AM,T512,0,245,41,286
AM,T593,0,2805,1968,4773
AM,T594,0,2953,2449,5402
AM,T596,0,730,820,1550
AM,T597,0,0,49,49
AM,T598,0,223,371,594
AM,Island Ferry,0,63,0,63
AM,Private Bus,0,22,36,58
AM,Y002,0,53,15,68
AM,Y003,0,18,0,18
AM,Y012,0,42,0,42
AM,Y024,0,22,0,22
AM,Y085,0,13,0,13
AM,Y088,0,23,0,23
AM,Y900,0,25,27,52
AM,Not Used,73,321916,261571,583560
AM,BR11,0,28,0,28
AM,BR15,0,0,28,28
AM,BR18,0,23,0,23
AM,GB34,0,0,32,32
AM,GB94,0,17,0,17
AM,MS38,0,0,17,17
AM,T006,0,60,0,60
AM,T007,0,18,0,18
AM,T017,0,0,26,26
AM,T021,0,48,0,48
AM,T025,0,0,122,122
AM,T029,0,22,0,22
AM,T032,0,0,22,22
AM,T034,0,43,20,63
AM,T036,0,0,30,30
AM,T038,0,0,61,61
AM,T039,0,29,0,29
AM,T045,0,0,18,18
AM,T047,0,26,0,26
AM,T051,0,40,23,63
AM,T052,0,86,0,86
AM,T054,0,19,0,19
AM,T063,0,24,0,24
AM,T070,0,0,16,16
AM,T071,0,28,0,28
AM,T072,0,0,22,22
AM,T076,0,0,19,19
AM,T081,0,27,0,27
AM,T084,0,16,88,104
AM,T085,0,37,33,70
AM,T095,0,42,17,59
AM,T096,0,19,52,71
AM,T106,0,19,0,19
AM,T108,0,46,0,46
AM,T112,0,38,0,38
AM,T116,0,0,23,23
AM,T117,0,25,0,25
AM,T124,0,17,0,17
AM,T129,0,0,21,21
AM,T134,0,31,28,59
AM,T169,0,0,28,28
AM,T196,0,172,65,237
AM,T199,0,0,17,17
AM,T501,0,67,29,96
AM,T504,0,0,96,96
AM,T505,0,55,25,80
AM,T506,0,21,0,21
AM,T509,0,0,27,27
AM,T510,0,57,0,57
AM,T511,0,21,0,21
AM,T512,0,19,0,19
AM,T593,0,223,139,362
AM,T594,0,252,245,497
AM,T596,0,99,50,149
AM,T597,0,0,30,30
AM,T598,0,23,0,23
AM,Island Ferry,0,57,0,57
AM,Private Bus,0,0,26,26
AM,Y020,0,0,13,13
AM,Y077,0,0,27,27
AM,Y090,0,0,60,60
AM,Y902,0,18,0,18
AM,Not Used,73,323608,263006,586687
AM,BR07,0,28,0,28
AM,T007,0,16,60,76
AM,T068,0,0,29,29
AM,T085,0,23,0,23
AM,T091,0,19,0,19
AM,T096,0,18,0,18
AM,T196,0,34,33,67
AM,T501,0,0,19,19
AM,T504,0,31,0,31
AM,T511,0,18,0,18
AM,T593,0,32,21,53
MD,Not Used,28,272483,188765,461276
MD,D225,0,24,0,24
MD,T024,0,43,0,43
MD,T032,0,23,0,23
MD,T054,0,27,15,42
MD,T105,0,23,0,23
MD,T593,0,18,30,48
MD,Not Used,28,271109,187866,459003
MD,BR02,0,22,0,22
MD,D306,0,26,0,26
MD,D401,0,29,0,29
MD,D915,0,20,0,20
MD,GB94,0,24,0,24
MD,MS01,0,22,0,22
MD,MS19,0,0,22,22
MD,T007,0,35,0,35
MD,T011,0,28,0,28
MD,T017,0,60,0,60
MD,T020,0,34,0,34
MD,T022,0,0,30,30
MD,T023,0,21,0,21
MD,T025,0,62,34,96
MD,T029,0,15,0,15
MD,T032,0,33,0,33
MD,T034,0,24,24,48
MD,T035,0,46,0,46
MD,T038,0,28,0,28
MD,T039,0,31,0,31
MD,T047,0,40,0,40
MD,T051,0,0,33,33
MD,T052,0,14,12,26
MD,T053,0,24,29,53
MD,T054,0,43,22,65
MD,T060,0,0,13,13
MD,T078,0,0,24,24
MD,T082,0,27,0,27
MD,T085,0,112,0,112
MD,T090,0,23,0,23
MD,T106,0,0,69,69
MD,T107,0,21,0,21
MD,T108,0,14,33,47
MD,T109,0,16,0,16
MD,T111,0,0,14,14
MD,T112,0,17,0,17
MD,T124,0,15,29,44
MD,T125,0,17,0,17
MD,T127,0,29,0,29
MD,T131,0,22,0,22
MD,T133,0,31,0,31
MD,T134,0,0,15,15
MD,T139,0,0,34,34
MD,T160,0,0,17,17
MD,T161,0,17,0,17
MD,T162,0,15,0,15
MD,T190,0,18,0,18
MD,T196,0,52,68,120
MD,T199,0,0,28,28
MD,T501,0,60,22,82
MD,T504,0,29,0,29
MD,T505,0,17,130,147
MD,T506,0,14,11,25
MD,T510,0,0,33,33
MD,T512,0,0,19,19
MD,T593,0,143,40,183
MD,T594,0,28,45,73
MD,T596,0,30,60,90
MD,T597,0,27,0,27
MD,T598,0,0,12,12
MD,Y900,0,23,21,44
MD,Y901,0,34,0,34
MD,Not Used,28,262480,181599,444107
MD,BR07,0,22,0,22
MD,BR08,0,29,0,29
MD,BR11,0,60,19,79
MD,BR18,0,43,18,61
MD,BR19,0,0,27,27
MD,BR20,0,0,19,19
MD,BR24,0,43,0,43
MD,BR30,0,0,57,57
MD,BR50,0,28,0,28
MD,D224,0,30,0,30
MD,D225,0,24,0,24
MD,D302,0,26,0,26
MD,GB33,0,29,0,29
MD,GB34,0,0,23,23
MD,GB66,0,0,60,60
MD,GB93,0,47,45,92
MD,GB94,0,49,29,78
MD,GT01,0,0,39,39
MD,GT02,0,0,20,20
MD,GT03,0,0,28,28
MD,GT09,0,0,26,26
MD,HA05,0,34,0,34
MD,MS01,0,19,65,84
MD,MS05,0,0,21,21
MD,MS06,0,0,27,27
MD,MS08,0,17,0,17
MD,MS101,0,24,0,24
MD,MS110,0,31,50,81
MD,MS15,0,17,0,17
MD,MS66,0,48,23,71
MD,OA19,0,22,0,22
MD,SC08,0,18,0,18
MD,SC16,0,0,14,14
MD,T005,0,13,16,29
MD,T006,0,23,24,47
MD,T007,0,78,0,78
MD,T011,0,114,66,180
MD,T016,0,72,0,72
MD,T017,0,22,0,22
MD,T021,0,14,12,26
MD,T022,0,23,0,23
MD,T024,0,27,41,68
MD,T025,0,290,80,370
MD,T029,0,48,97,145
MD,T031,0,53,0,53
MD,T032,0,118,0,118
MD,T034,0,206,153,359
MD,T035,0,117,60,177
MD,T036,0,13,68,81
MD,T037,0,48,0,48
MD,T038,0,131,124,255
MD,T039,0,91,29,120
MD,T040,0,21,15,36
MD,T041,0,20,28,48
MD,T042,0,13,31,44
MD,T043,0,38,49,87
MD,T044,0,47,0,47
MD,T045,0,0,24,24
MD,T046,0,34,17,51
MD,T047,0,116,32,148
MD,T051,0,11,23,34
MD,T052,0,129,71,200
MD,T053,0,47,64,111
MD,T054,0,232,28,260
MD,T057,0,0,32,32
MD,T060,0,14,51,65
MD,T061,0,53,0,53
MD,T062,0,37,12,49
MD,T063,0,61,0,61
MD,T064,0,32,49,81
MD,T066,0,0,28,28
MD,T067,0,34,0,34
MD,T068,0,18,53,71
MD,T070,0,114,0,114
MD,T071,0,17,0,17
MD,T072,0,0,44,44
MD,T076,0,13,0,13
MD,T078,0,23,0,23
MD,T079,0,22,0,22
MD,T082,0,11,0,11
MD,T084,0,132,90,222
MD,T085,0,59,134,193
MD,T086,0,94,0,94
MD,T087,0,29,0,29
MD,T088,0,16,0,16
MD,T089,0,30,0,30
MD,T090,0,18,48,66
MD,T091,0,0,14,14
MD,T092,0,17,0,17
MD,T094,0,17,0,17
MD,T095,0,79,32,111
MD,T096,0,127,152,279
MD,T097,0,13,25,38
MD,T098,0,32,0,32
MD,T100,0,18,22,40
MD,T102,0,35,0,35
MD,T106,0,85,33,118
MD,T107,0,22,18,40
MD,T108,0,45,23,68
MD,T109,0,33,19,52
MD,T112,0,0,21,21
MD,T113,0,0,21,21
MD,T116,0,54,24,78
MD,T117,0,62,0,62
MD,T123,0,35,0,35
MD,T124,0,107,53,160
MD,T125,0,26,55,81
MD,T129,0,226,61,287
MD,T131,0,60,90,150
MD,T132,0,0,10,10
MD,T133,0,30,33,63
MD,T134,0,57,246,303
MD,T135,0,0,15,15
MD,T160,0,35,0,35
MD,T165,0,0,33,33
MD,T168,0,15,0,15
MD,T190,0,21,0,21
MD,T191,0,17,18,35
MD,T192,0,52,0,52
MD,T196,0,440,600,1040
MD,T199,0,0,32,32
MD,T501,0,144,95,239
MD,T504,0,335,179,514
MD,T505,0,118,112,230
MD,T506,0,60,59,119
MD,T509,0,22,0,22
MD,T510,0,242,61,303
MD,T511,0,73,13,86
MD,T512,0,93,69,162
MD,T593,0,920,857,1777
MD,T594,0,1424,1092,2516
MD,T596,0,676,296,972
MD,T597,0,104,125,229
MD,T598,0,281,177,458
MD,Island Ferry,0,17,18,35
MD,Private Bus,0,15,0,15
MD,Y020,0,15,0,15
MD,Y077,0,22,0,22
MD,Y088,0,0,28,28
MD,Y091,0,18,0,18
MD,Y900,0,62,31,93
MD,Y901,0,57,19,76
MD,Y904,0,0,26,26
MD,BA28,0,20,34,54
MD,BR01,0,0,23,23
MD,BR02,0,47,28,75
MD,BR03,0,43,0,43
MD,BR04,0,28,61,89
MD,BR05,0,41,29,70
MD,BR07,0,88,28,116
MD,BR09,0,55,0,55
MD,BR10,0,26,0,26
MD,BR101,0,23,0,23
MD,BR11,0,88,46,134
MD,BR12,0,23,0,23
MD,BR14,0,23,31,54
MD,BR15,0,59,28,87
MD,BR17,0,27,45,72
MD,BR18,0,27,91,118
MD,BR19,0,19,0,19
MD,BR23,0,25,0,25
MD,BR29,0,17,0,17
MD,BR30,0,54,0,54
MD,BR35,0,23,23,46
MD,BR40,0,0,22,22
MD,BR50,0,28,0,28
MD,BR501,0,88,28,116
MD,BR502,0,77,27,104
MD,BR51,0,28,0,28
MD,BR52,0,60,0,60
MD,BR53,0,57,0,57
MD,BT02,0,47,0,47
MD,BU01,0,0,28,28
MD,BU02,0,64,16,80
MD,BU06,0,28,0,28
MD,BU10,0,57,0,57
MD,BU11,0,13,34,47
MD,BU15,0,23,0,23
MD,D112,0,0,29,29
MD,D141,0,29,0,29
MD,D219,0,20,0,20
MD,D221,0,54,0,54
MD,D222,0,0,30,30
MD,D302,0,24,0,24
MD,D401,0,26,0,26
MD,D407,0,34,0,34
MD,D408,0,12,0,12
MD,D410,0,21,0,21
MD,D916,0,34,0,34
MD,GB12,0,0,26,26
MD,GB15,0,0,52,52
MD,GB16,0,17,47,64
MD,GB31,0,23,29,52
MD,GB34,0,43,0,43
MD,GB46,0,29,85,114
MD,GB52,0,60,152,212
MD,GB61,0,0,27,27
MD,GB65,0,49,18,67
MD,GB66,0,35,0,35
MD,GB93,0,26,68,94
MD,GB94,0,30,46,76
MD,GT01,0,113,95,208
MD,GT03,0,28,0,28
MD,GT09,0,158,86,244
MD,HA01,0,15,13,28
MD,HA02,0,0,13,13
MD,HA04,0,0,23,23
MD,HA05,0,23,20,43
MD,HA10,0,31,0,31
MD,HA11,0,31,0,31
MD,HA21,0,23,28,51
MD,HA24,0,36,0,36
MD,HA25,0,13,0,13
MD,HA27,0,20,0,20
MD,HA33,0,0,30,30
MD,HA34,0,14,0,14
MD,HA35,0,24,0,24
MD,HA41,0,0,34,34
MD,HA55,0,40,0,40
MD,MS01,0,185,190,375
MD,MS03,0,50,79,129
MD,MS04,0,22,0,22
MD,MS06,0,29,0,29
MD,MS07,0,23,0,23
MD,MS08,0,19,0,19
MD,MS09,0,0,58,58
MD,MS101,0,21,0,21
MD,MS103,0,23,19,42
MD,MS11,0,60,19,79
MD,MS110,0,57,110,167
MD,MS12,0,77,0,77
MD,MS13,0,47,26,73
MD,MS19,0,74,60,134
MD,MS22,0,0,56,56
MD,MS23,0,51,0,51
MD,MS26,0,93,96,189
MD,MS28,0,48,0,48
MD,MS29,0,41,0,41
MD,MS30,0,20,0,20
MD,MS33,0,0,29,29
MD,MS34,0,51,14,65
MD,MS35,0,0,52,52
MD,MS36,0,0,29,29
MD,MS38,0,0,14,14
MD,MS39,0,0,23,23
MD,MS41,0,29,0,29
MD,MS42,0,104,23,127
MD,MS43,0,25,0,25
MD,MS44,0,50,29,79
MD,MS45,0,0,21,21
MD,MS48,0,22,0,22
MD,MS49,0,0,21,21
MD,MS51,0,19,0,19
MD,MS53,0,22,0,22
MD,MS57,0,0,17,17
MD,MS61,0,47,49,96
MD,MS66,0,51,0,51
MD,MS76,0,34,0,34
MD,MS990,0,0,20,20
MD,NI15,0,26,0,26
MD,OA01,0,89,13,102
MD,OA03,0,37,0,37
MD,OA06,0,0,20,20
MD,OA14,0,23,0,23
MD,OA19,0,0,33,33
MD,OA24,0,51,33,84
MD,PE03,0,26,0,26
MD,SC05,0,25,0,25
MD,SC12,0,18,0,18
MD,SC66,0,34,0,34
MD,T006,0,102,67,169
MD,T007,0,184,146,330
MD,T008,0,24,34,58
MD,T009,0,51,0,51
MD,T011,0,150,211,361
MD,T012,0,105,72,177
MD,T014,0,27,0,27
MD,T015,0,37,0,37
MD,T016,0,148,48,196
MD,T017,0,145,115,260
MD,T020,0,114,21,135
MD,T021,0,99,28,127
MD,T022,0,266,101,367
MD,T023,0,47,80,127
MD,T024,0,294,342,636
MD,T025,0,505,360,865
MD,T026,0,40,0,40
MD,T028,0,49,38,87
MD,T029,0,386,403,789
MD,T030,0,69,0,69
MD,T032,0,180,186,366
MD,T033,0,32,10,42
MD,T034,0,331,93,424
MD,T035,0,356,287,643
MD,T036,0,491,155,646
MD,T037,0,293,145,438
MD,T038,0,418,118,536
MD,T039,0,135,188,323
MD,T040,0,99,77,176
MD,T041,0,628,396,1024
MD,T042,0,103,28,131
MD,T043,0,244,271,515
MD,T044,0,82,144,226
MD,T045,0,184,166,350
MD,T046,0,103,0,103
MD,T047,0,199,13,212
MD,T048,0,65,65,130
MD,T049,0,49,12,61
MD,T050,0,0,44,44
MD,T051,0,24,0,24
MD,T052,0,506,102,608
MD,T053,0,79,100,179
MD,T054,0,272,213,485
MD,T056,0,54,18,72
MD,T057,0,54,36,90
MD,T058,0,87,152,239
MD,T059,0,0,29,29
MD,T060,0,242,315,557
MD,T061,0,0,24,24
MD,T062,0,29,27,56
MD,T063,0,234,298,532
MD,T064,0,26,41,67
MD,T065,0,84,33,117
MD,T066,0,79,173,252
MD,T067,0,212,25,237
MD,T068,0,221,232,453
MD,T069,0,92,84,176
MD,T070,0,193,75,268
MD,T071,0,177,100,277
MD,T072,0,22,111,133
MD,T073,0,165,107,272
MD,T075,0,118,9,127
MD,T076,0,133,50,183
MD,T077,0,15,0,15
MD,T078,0,54,22,76
MD,T079,0,161,43,204
MD,T080,0,16,0,16
MD,T081,0,35,62,97
MD,T082,0,15,0,15
MD,T083,0,30,0,30
MD,T084,0,302,275,577
MD,T085,0,292,239,531
MD,T086,0,78,90,168
MD,T087,0,152,43,195
MD,T088,0,32,10,42
MD,T089,0,276,170,446
MD,T090,0,92,41,133
MD,T091,0,56,100,156
MD,T092,0,17,24,41
MD,T094,0,140,96,236
MD,T095,0,464,199,663
MD,T096,0,291,173,464
MD,T097,0,16,37,53
MD,T098,0,40,0,40
MD,T100,0,120,132,252
MD,T102,0,235,185,420
MD,T103,0,0,11,11
MD,T104,0,43,0,43
MD,T105,0,113,0,113
MD,T106,0,137,146,283
MD,T107,0,139,106,245
MD,T108,0,59,125,184
MD,T109,0,86,0,86
MD,T110,0,105,140,245
MD,T111,0,109,78,187
MD,T112,0,95,46,141
MD,T113,0,29,19,48
MD,T116,0,281,272,553
MD,T117,0,0,19,19
MD,T120,0,0,61,61
MD,T122,0,96,0,96
MD,T123,0,128,41,169
MD,T124,0,241,42,283
MD,T125,0,0,16,16
MD,T126,0,35,0,35
MD,T129,0,173,154,327
MD,T130,0,29,29,58
MD,T131,0,60,0,60
MD,T132,0,21,0,21
MD,T133,0,166,116,282
MD,T134,0,178,90,268
MD,T135,0,47,17,64
MD,T139,0,21,0,21
MD,T160,0,35,19,54
MD,T161,0,81,0,81
MD,T165,0,234,148,382
MD,T168,0,154,41,195
MD,T169,0,13,0,13
MD,T190,0,118,0,118
MD,T191,0,359,245,604
MD,T192,0,54,78,132
MD,T196,0,1071,878,1949
MD,T199,0,92,78,170
MD,T224,0,29,27,56
MD,T501,0,270,258,528
MD,T502,0,21,0,21
MD,T504,0,676,805,1481
MD,T505,0,247,200,447
MD,T506,0,492,352,844
MD,T509,0,193,93,286
MD,T510,0,521,413,934
MD,T511,0,249,271,520
MD,T512,0,213,124,337
MD,T593,0,5372,4369,9741
MD,T594,0,8604,7477,16081
MD,T596,0,6633,4390,11023
MD,T597,0,1150,1041,2191
MD,T598,0,780,399,1179
MD,WA07,0,0,16,16
MD,WA08,0,31,0,31
MD,WA10,0,31,0,31
MD,WA16,0,0,22,22
MD,WA201,0,17,0,17
MD,WA21,0,26,0,26
MD,WA25,0,13,32,45
MD,WA35,0,19,0,19
MD,WA52,0,12,0,12
MD,WA55,0,28,0,28
MD,WA64,0,0,17,17
MD,WA66,0,31,0,31
MD,WA71,0,41,0,41
MD,WA90,0,41,0,41
MD,WE05,0,26,0,26
MD,WE06,0,26,0,26
MD,Canada Coach,0,0,14,14
MD,Island Ferry,0,41,33,74
MD,Grey Hound,0,0,57,57
MD,Erindale School,0,0,17,17
MD,Private Bus,0,137,76,213
MD,Y004,0,58,18,76
MD,Y005,0,20,0,20
MD,Y007,0,26,47,73
MD,Y008,0,0,20,20
MD,Y012,0,18,0,18
MD,Y013,0,20,0,20
MD,Y020,0,0,56,56
MD,Y022,0,49,0,49
MD,Y024,0,0,18,18
MD,Y042,0,0,22,22
MD,Y077,0,18,0,18
MD,Y081,0,0,23,23
MD,Y085,0,48,16,64
MD,Y088,0,25,27,52
MD,Y090,0,0,22,22
MD,Y099,0,0,31,31
MD,Y900,0,154,28,182
MD,Y901,0,100,20,120
MD,Not Used,28,262480,181599,444107
MD,BR07,0,22,0,22
MD,BR08,0,29,0,29
MD,BR11,0,60,19,79
MD,BR18,0,43,18,61
MD,BR19,0,0,27,27
MD,BR20,0,0,19,19
MD,BR24,0,43,0,43
MD,BR30,0,0,57,57
MD,BR50,0,28,0,28
MD,D224,0,30,0,30
MD,D225,0,24,0,24
MD,D302,0,26,0,26
MD,GB33,0,29,0,29
MD,GB34,0,0,23,23
MD,GB66,0,0,60,60
MD,GB93,0,47,45,92
MD,GB94,0,49,29,78
MD,GT01,0,0,39,39
MD,GT02,0,0,20,20
MD,GT03,0,0,28,28
MD,GT09,0,0,26,26
MD,HA05,0,34,0,34
MD,MS01,0,19,65,84
MD,MS05,0,0,21,21
MD,MS06,0,0,27,27
MD,MS08,0,17,0,17
MD,MS101,0,24,0,24
MD,MS110,0,31,50,81
MD,MS15,0,17,0,17
MD,MS66,0,48,23,71
MD,OA19,0,22,0,22
MD,SC08,0,18,0,18
MD,SC16,0,0,14,14
MD,T005,0,13,16,29
MD,T006,0,23,24,47
MD,T007,0,78,0,78
MD,T011,0,114,66,180
MD,T016,0,72,0,72
MD,T017,0,22,0,22
MD,T021,0,14,12,26
MD,T022,0,23,0,23
MD,T024,0,27,41,68
MD,T025,0,290,80,370
MD,T029,0,48,97,145
MD,T031,0,53,0,53
MD,T032,0,118,0,118
MD,T034,0,206,153,359
MD,T035,0,117,60,177
MD,T036,0,13,68,81
MD,T037,0,48,0,48
MD,T038,0,131,124,255
MD,T039,0,91,29,120
MD,T040,0,21,15,36
MD,T041,0,20,28,48
MD,T042,0,13,31,44
MD,T043,0,38,49,87
MD,T044,0,47,0,47
MD,T045,0,0,24,24
MD,T046,0,34,17,51
MD,T047,0,116,32,148
MD,T051,0,11,23,34
MD,T052,0,129,71,200
MD,T053,0,47,64,111
MD,T054,0,232,28,260
MD,T057,0,0,32,32
MD,T060,0,14,51,65
MD,T061,0,53,0,53
MD,T062,0,37,12,49
MD,T063,0,61,0,61
MD,T064,0,32,49,81
MD,T066,0,0,28,28
MD,T067,0,34,0,34
MD,T068,0,18,53,71
MD,T070,0,114,0,114
MD,T071,0,17,0,17
MD,T072,0,0,44,44
MD,T076,0,13,0,13
MD,T078,0,23,0,23
MD,T079,0,22,0,22
MD,T082,0,11,0,11
MD,T084,0,132,90,222
MD,T085,0,59,134,193
MD,T086,0,94,0,94
MD,T087,0,29,0,29
MD,T088,0,16,0,16
MD,T089,0,30,0,30
MD,T090,0,18,48,66
MD,T091,0,0,14,14
MD,T092,0,17,0,17
MD,T094,0,17,0,17
MD,T095,0,79,32,111
MD,T096,0,127,152,279
MD,T097,0,13,25,38
MD,T098,0,32,0,32
MD,T100,0,18,22,40
MD,T102,0,35,0,35
MD,T106,0,85,33,118
MD,T107,0,22,18,40
MD,T108,0,45,23,68
MD,T109,0,33,19,52
MD,T112,0,0,21,21
MD,T113,0,0,21,21
MD,T116,0,54,24,78
MD,T117,0,62,0,62
MD,T123,0,35,0,35
MD,T124,0,107,53,160
MD,T125,0,26,55,81
MD,T129,0,226,61,287
MD,T131,0,60,90,150
MD,T132,0,0,10,10
MD,T133,0,30,33,63
MD,T134,0,57,246,303
MD,T135,0,0,15,15
MD,T160,0,35,0,35
MD,T165,0,0,33,33
MD,T168,0,15,0,15
MD,T190,0,21,0,21
MD,T191,0,17,18,35
MD,T192,0,52,0,52
MD,T196,0,440,600,1040
MD,T199,0,0,32,32
MD,T501,0,144,95,239
MD,T504,0,335,179,514
MD,T505,0,118,112,230
MD,T506,0,60,59,119
MD,T509,0,22,0,22
MD,T510,0,242,61,303
MD,T511,0,73,13,86
MD,T512,0,93,69,162
MD,T593,0,920,857,1777
MD,T594,0,1424,1092,2516
MD,T596,0,676,296,972
MD,T597,0,104,125,229
MD,T598,0,281,177,458
MD,Island Ferry,0,17,18,35
MD,Private Bus,0,15,0,15
MD,Y020,0,15,0,15
MD,Y077,0,22,0,22
MD,Y088,0,0,28,28
MD,Y091,0,18,0,18
MD,Y900,0,62,31,93
MD,Y901,0,57,19,76
MD,Y904,0,0,26,26
MD,Not Used,28,224478,153463,377969
MD,BA28,0,20,34,54
MD,BR01,0,0,23,23
MD,BR02,0,47,28,75
MD,BR03,0,43,0,43
MD,BR04,0,28,61,89
MD,BR05,0,41,29,70
MD,BR07,0,88,28,116
MD,BR09,0,55,0,55
MD,BR10,0,26,0,26
MD,BR101,0,23,0,23
MD,BR11,0,88,46,134
MD,BR12,0,23,0,23
MD,BR14,0,23,31,54
MD,BR15,0,59,28,87
MD,BR17,0,27,45,72
MD,BR18,0,27,91,118
MD,BR19,0,19,0,19
MD,BR23,0,25,0,25
MD,BR29,0,17,0,17
MD,BR30,0,54,0,54
MD,BR35,0,23,23,46
MD,BR40,0,0,22,22
MD,BR50,0,28,0,28
MD,BR501,0,88,28,116
MD,BR502,0,77,27,104
MD,BR51,0,28,0,28
MD,BR52,0,60,0,60
MD,BR53,0,57,0,57
MD,BT02,0,47,0,47
MD,BU01,0,0,28,28
MD,BU02,0,64,16,80
MD,BU06,0,28,0,28
MD,BU10,0,57,0,57
MD,BU11,0,13,34,47
MD,BU15,0,23,0,23
MD,D112,0,0,29,29
MD,D141,0,29,0,29
MD,D219,0,20,0,20
MD,D221,0,54,0,54
MD,D222,0,0,30,30
MD,D302,0,24,0,24
MD,D401,0,26,0,26
MD,D407,0,34,0,34
MD,D408,0,12,0,12
MD,D410,0,21,0,21
MD,D916,0,34,0,34
MD,GB12,0,0,26,26
MD,GB15,0,0,52,52
MD,GB16,0,17,47,64
MD,GB31,0,23,29,52
MD,GB34,0,43,0,43
MD,GB46,0,29,85,114
MD,GB52,0,60,152,212
MD,GB61,0,0,27,27
MD,GB65,0,49,18,67
MD,GB66,0,35,0,35
MD,GB93,0,26,68,94
MD,GB94,0,30,46,76
MD,GT01,0,113,95,208
MD,GT03,0,28,0,28
MD,GT09,0,158,86,244
MD,HA01,0,15,13,28
MD,HA02,0,0,13,13
MD,HA04,0,0,23,23
MD,HA05,0,23,20,43
MD,HA10,0,31,0,31
MD,HA11,0,31,0,31
MD,HA21,0,23,28,51
MD,HA24,0,36,0,36
MD,HA25,0,13,0,13
MD,HA27,0,20,0,20
MD,HA33,0,0,30,30
MD,HA34,0,14,0,14
MD,HA35,0,24,0,24
MD,HA41,0,0,34,34
MD,HA55,0,40,0,40
MD,MS01,0,185,190,375
MD,MS03,0,50,79,129
MD,MS04,0,22,0,22
MD,MS06,0,29,0,29
MD,MS07,0,23,0,23
MD,MS08,0,19,0,19
MD,MS09,0,0,58,58
MD,MS101,0,21,0,21
MD,MS103,0,23,19,42
MD,MS11,0,60,19,79
MD,MS110,0,57,110,167
MD,MS12,0,77,0,77
MD,MS13,0,47,26,73
MD,MS19,0,74,60,134
MD,MS22,0,0,56,56
MD,MS23,0,51,0,51
MD,MS26,0,93,96,189
MD,MS28,0,48,0,48
MD,MS29,0,41,0,41
MD,MS30,0,20,0,20
MD,MS33,0,0,29,29
MD,MS34,0,51,14,65
MD,MS35,0,0,52,52
MD,MS36,0,0,29,29
MD,MS38,0,0,14,14
MD,MS39,0,0,23,23
MD,MS41,0,29,0,29
MD,MS42,0,104,23,127
MD,MS43,0,25,0,25
MD,MS44,0,50,29,79
MD,MS45,0,0,21,21
MD,MS48,0,22,0,22
MD,MS49,0,0,21,21
MD,MS51,0,19,0,19
MD,MS53,0,22,0,22
MD,MS57,0,0,17,17
MD,MS61,0,47,49,96
MD,MS66,0,51,0,51
MD,MS76,0,34,0,34
MD,MS990,0,0,20,20
MD,NI15,0,26,0,26
MD,OA01,0,89,13,102
MD,OA03,0,37,0,37
MD,OA06,0,0,20,20
MD,OA14,0,23,0,23
MD,OA19,0,0,33,33
MD,OA24,0,51,33,84
MD,PE03,0,26,0,26
MD,SC05,0,25,0,25
MD,SC12,0,18,0,18
MD,SC66,0,34,0,34
MD,T006,0,102,67,169
MD,T007,0,184,146,330
MD,T008,0,24,34,58
MD,T009,0,51,0,51
MD,T011,0,150,211,361
MD,T012,0,105,72,177
MD,T014,0,27,0,27
MD,T015,0,37,0,37
MD,T016,0,148,48,196
MD,T017,0,145,115,260
MD,T020,0,114,21,135
MD,T021,0,99,28,127
MD,T022,0,266,101,367
MD,T023,0,47,80,127
MD,T024,0,294,342,636
MD,T025,0,505,360,865
MD,T026,0,40,0,40
MD,T028,0,49,38,87
MD,T029,0,386,403,789
MD,T030,0,69,0,69
MD,T032,0,180,186,366
MD,T033,0,32,10,42
MD,T034,0,331,93,424
MD,T035,0,356,287,643
MD,T036,0,491,155,646
MD,T037,0,293,145,438
MD,T038,0,418,118,536
MD,T039,0,135,188,323
MD,T040,0,99,77,176
MD,T041,0,628,396,1024
MD,T042,0,103,28,131
MD,T043,0,244,271,515
MD,T044,0,82,144,226
MD,T045,0,184,166,350
MD,T046,0,103,0,103
MD,T047,0,199,13,212
MD,T048,0,65,65,130
MD,T049,0,49,12,61
MD,T050,0,0,44,44
MD,T051,0,24,0,24
MD,T052,0,506,102,608
MD,T053,0,79,100,179
MD,T054,0,272,213,485
MD,T056,0,54,18,72
MD,T057,0,54,36,90
MD,T058,0,87,152,239
MD,T059,0,0,29,29
MD,T060,0,242,315,557
MD,T061,0,0,24,24
MD,T062,0,29,27,56
MD,T063,0,234,298,532
MD,T064,0,26,41,67
MD,T065,0,84,33,117
MD,T066,0,79,173,252
MD,T067,0,212,25,237
MD,T068,0,221,232,453
MD,T069,0,92,84,176
MD,T070,0,193,75,268
MD,T071,0,177,100,277
MD,T072,0,22,111,133
MD,T073,0,165,107,272
MD,T075,0,118,9,127
MD,T076,0,133,50,183
MD,T077,0,15,0,15
MD,T078,0,54,22,76
MD,T079,0,161,43,204
MD,T080,0,16,0,16
MD,T081,0,35,62,97
MD,T082,0,15,0,15
MD,T083,0,30,0,30
MD,T084,0,302,275,577
MD,T085,0,292,239,531
MD,T086,0,78,90,168
MD,T087,0,152,43,195
MD,T088,0,32,10,42
MD,T089,0,276,170,446
MD,T090,0,92,41,133
MD,T091,0,56,100,156
MD,T092,0,17,24,41
MD,T094,0,140,96,236
MD,T095,0,464,199,663
MD,T096,0,291,173,464
MD,T097,0,16,37,53
MD,T098,0,40,0,40
MD,T100,0,120,132,252
MD,T102,0,235,185,420
MD,T103,0,0,11,11
MD,T104,0,43,0,43
MD,T105,0,113,0,113
MD,T106,0,137,146,283
MD,T107,0,139,106,245
MD,T108,0,59,125,184
MD,T109,0,86,0,86
MD,T110,0,105,140,245
MD,T111,0,109,78,187
MD,T112,0,95,46,141
MD,T113,0,29,19,48
MD,T116,0,281,272,553
MD,T117,0,0,19,19
MD,T120,0,0,61,61
MD,T122,0,96,0,96
MD,T123,0,128,41,169
MD,T124,0,241,42,283
MD,T125,0,0,16,16
MD,T126,0,35,0,35
MD,T129,0,173,154,327
MD,T130,0,29,29,58
MD,T131,0,60,0,60
MD,T132,0,21,0,21
MD,T133,0,166,116,282
MD,T134,0,178,90,268
MD,T135,0,47,17,64
MD,T139,0,21,0,21
MD,T160,0,35,19,54
MD,T161,0,81,0,81
MD,T165,0,234,148,382
MD,T168,0,154,41,195
MD,T169,0,13,0,13
MD,T190,0,118,0,118
MD,T191,0,359,245,604
MD,T192,0,54,78,132
MD,T196,0,1071,878,1949
MD,T199,0,92,78,170
MD,T224,0,29,27,56
MD,T501,0,270,258,528
MD,T502,0,21,0,21
MD,T504,0,676,805,1481
MD,T505,0,247,200,447
MD,T506,0,492,352,844
MD,T509,0,193,93,286
MD,T510,0,521,413,934
MD,T511,0,249,271,520
MD,T512,0,213,124,337
MD,T593,0,5372,4369,9741
MD,T594,0,8604,7477,16081
MD,T596,0,6633,4390,11023
MD,T597,0,1150,1041,2191
MD,T598,0,780,399,1179
MD,WA07,0,0,16,16
MD,WA08,0,31,0,31
MD,WA10,0,31,0,31
MD,WA16,0,0,22,22
MD,WA201,0,17,0,17
MD,WA21,0,26,0,26
MD,WA25,0,13,32,45
MD,WA35,0,19,0,19
MD,WA52,0,12,0,12
MD,WA55,0,28,0,28
MD,WA64,0,0,17,17
MD,WA66,0,31,0,31
MD,WA71,0,41,0,41
MD,WA90,0,41,0,41
MD,WE05,0,26,0,26
MD,WE06,0,26,0,26
MD,Canada Coach,0,0,14,14
MD,Island Ferry,0,41,33,74
MD,Grey Hound,0,0,57,57
MD,Erindale School,0,0,17,17
MD,Private Bus,0,137,76,213
MD,Y004,0,58,18,76
MD,Y005,0,20,0,20
MD,Y007,0,26,47,73
MD,Y008,0,0,20,20
MD,Y012,0,18,0,18
MD,Y013,0,20,0,20
MD,Y020,0,0,56,56
MD,Y022,0,49,0,49
MD,Y024,0,0,18,18
MD,Y042,0,0,22,22
MD,Y077,0,18,0,18
MD,Y081,0,0,23,23
MD,Y085,0,48,16,64
MD,Y088,0,25,27,52
MD,Y090,0,0,22,22
MD,Y099,0,0,31,31
MD,Y900,0,154,28,182
MD,Y901,0,100,20,120
MD,Not Used,28,129884,86627,216539
MD,BA10,0,144,58,202
MD,BA11,0,257,103,360
MD,BA14,0,45,20,65
MD,BA15,0,54,0,54
MD,BA16,0,20,25,45
MD,BA18,0,0,12,12
MD,BA20,0,54,24,78
MD,BA24,0,43,0,43
MD,BA30,0,43,78,121
MD,BA31,0,54,24,78
MD,BA34,0,92,34,126
MD,BA39,0,34,45,79
MD,BA41,0,34,25,59
MD,BR01,0,303,175,478
MD,BR02,0,181,17,198
MD,BR03,0,131,140,271
MD,BR04,0,186,28,214
MD,BR05,0,296,134,430
MD,BR07,0,232,73,305
MD,BR08,0,34,28,62
MD,BR09,0,74,23,97
MD,BR101,0,0,21,21
MD,BR11,0,571,408,979
MD,BR12,0,0,23,23
MD,BR13,0,22,0,22
MD,BR14,0,49,59,108
MD,BR15,0,202,101,303
MD,BR16,0,59,24,83
MD,BR17,0,22,50,72
MD,BR18,0,240,59,299
MD,BR19,0,24,31,55
MD,BR23,0,66,71,137
MD,BR24,0,23,29,52
MD,BR29,0,23,103,126
MD,BR30,0,73,31,104
MD,BR32,0,0,25,25
MD,BR40,0,23,0,23
MD,BR50,0,82,0,82
MD,BR501,0,744,610,1354
MD,BR502,0,386,358,744
MD,BR51,0,47,43,90
MD,BR52,0,185,101,286
MD,BR53,0,23,75,98
MD,BR54,0,22,0,22
MD,BT01,0,60,21,81
MD,BT02,0,103,0,103
MD,BT04,0,58,0,58
MD,BT05,0,42,0,42
MD,BT06,0,21,0,21
MD,BT07,0,62,50,112
MD,BT08,0,15,0,15
MD,BT09,0,71,0,71
MD,BU01,0,205,34,239
MD,BU02,0,21,28,49
MD,BU03,0,25,0,25
MD,BU04,0,22,0,22
MD,BU05,0,21,0,21
MD,BU06,0,35,35,70
MD,BU10,0,112,39,151
MD,BU11,0,0,51,51
MD,BU12,0,29,25,54
MD,BU80,0,35,0,35
MD,D101,0,0,29,29
MD,D103,0,18,24,42
MD,D107,0,0,24,24
MD,D110,0,18,0,18
MD,D111,0,24,29,53
MD,D112,0,15,0,15
MD,D121,0,42,0,42
MD,D122,0,15,0,15
MD,D219,0,54,0,54
MD,D222,0,0,24,24
MD,D224,0,22,18,40
MD,D302,0,67,0,67
MD,D304,0,22,0,22
MD,D305,0,0,61,61
MD,D306,0,40,40,80
MD,D401,0,149,139,288
MD,D402,0,179,98,277
MD,D403,0,33,23,56
MD,D406,0,19,21,40
MD,D407,0,0,50,50
MD,D408,0,66,43,109
MD,D409,0,43,0,43
MD,D410,0,45,74,119
MD,D411,0,0,47,47
MD,D420,0,0,31,31
MD,D915,0,112,145,257
MD,D916,0,164,84,248
MD,D923,0,18,27,45
MD,GB12,0,25,0,25
MD,GB15,0,117,112,229
MD,GB16,0,177,111,288
MD,GB19,0,17,28,45
MD,GB21,0,121,155,276
MD,GB25,0,52,29,81
MD,GB29,0,59,0,59
MD,GB31,0,144,0,144
MD,GB32,0,19,0,19
MD,GB34,0,120,18,138
MD,GB38,0,28,0,28
MD,GB46,0,392,394,786
MD,GB52,0,210,434,644
MD,GB61,0,45,0,45
MD,GB65,0,34,40,74
MD,GB66,0,14,13,27
MD,GB71,0,52,0,52
MD,GB81,0,0,12,12
MD,GB88,0,12,10,22
MD,GB90,0,0,47,47
MD,GB93,0,94,0,94
MD,GB94,0,353,249,602
MD,GB95,0,27,92,119
MD,GT01,0,909,809,1718
MD,GT02,0,131,77,208
MD,GT03,0,147,237,384
MD,GT05,0,221,168,389
MD,GT06,0,85,20,105
MD,GT07,0,90,52,142
MD,GT09,0,621,697,1318
MD,GU01,0,15,11,26
MD,GU06,0,0,19,19
MD,GU08,0,21,0,21
MD,GU09,0,14,20,34
MD,GU10,0,16,0,16
MD,GU22,0,28,23,51
MD,GU24,0,0,21,21
MD,GU32,0,114,0,114
MD,GU33,0,36,0,36
MD,GU34,0,23,0,23
MD,GU37,0,30,0,30
MD,GU38,0,17,0,17
MD,GU39,0,0,28,28
MD,GU42,0,0,17,17
MD,GU43,0,17,0,17
MD,GU52,0,18,48,66
MD,GU54,0,18,0,18
MD,GU61,0,14,0,14
MD,HA01,0,354,409,763
MD,HA02,0,184,253,437
MD,HA03,0,72,0,72
MD,HA04,0,291,198,489
MD,HA05,0,237,221,458
MD,HA06,0,19,0,19
MD,HA07,0,52,13,65
MD,HA08,0,37,0,37
MD,HA10,0,261,238,499
MD,HA11,0,212,78,290
MD,HA12,0,14,0,14
MD,HA21,0,268,116,384
MD,HA22,0,24,44,68
MD,HA23,0,121,181,302
MD,HA24,0,179,56,235
MD,HA25,0,176,68,244
MD,HA26,0,194,149,343
MD,HA27,0,175,173,348
MD,HA33,0,17,65,82
MD,HA34,0,107,0,107
MD,HA35,0,246,159,405
MD,HA41,0,321,106,427
MD,HA43,0,0,48,48
MD,HA44,0,22,0,22
MD,HA51,0,191,88,279
MD,HA52,0,57,0,57
MD,HA55,0,22,0,22
MD,HA91,0,19,0,19
MD,ML02,0,0,27,27
MD,MS01,0,601,555,1156
MD,MS03,0,441,236,677
MD,MS04,0,0,23,23
MD,MS05,0,229,120,349
MD,MS06,0,37,22,59
MD,MS07,0,205,131,336
MD,MS08,0,77,65,142
MD,MS09,0,65,73,138
MD,MS10,0,141,51,192
MD,MS101,0,30,45,75
MD,MS103,0,192,144,336
MD,MS107,0,28,0,28
MD,MS11,0,52,52,104
MD,MS110,0,637,583,1220
MD,MS12,0,26,0,26
MD,MS13,0,67,112,179
MD,MS14,0,29,0,29
MD,MS15,0,44,22,66
MD,MS16,0,23,0,23
MD,MS18,0,0,28,28
MD,MS19,0,788,481,1269
MD,MS20,0,178,60,238
MD,MS21,0,19,0,19
MD,MS22,0,89,29,118
MD,MS23,0,188,133,321
MD,MS26,0,390,403,793
MD,MS28,0,168,88,256
MD,MS29,0,18,29,47
MD,MS31,0,62,0,62
MD,MS34,0,130,88,218
MD,MS35,0,214,137,351
MD,MS36,0,40,0,40
MD,MS38,0,42,43,85
MD,MS39,0,121,27,148
MD,MS42,0,233,189,422
MD,MS44,0,137,141,278
MD,MS45,0,66,20,86
MD,MS48,0,147,138,285
MD,MS51,0,60,22,82
MD,MS53,0,29,0,29
MD,MS57,0,57,0,57
MD,MS61,0,66,233,299
MD,MS62,0,19,0,19
MD,MS65,0,28,0,28
MD,MS66,0,103,112,215
MD,MS68,0,37,0,37
MD,MS71,0,0,49,49
MD,MS76,0,94,28,122
MD,MS89,0,27,38,65
MD,MS90,0,22,0,22
MD,MS91,0,17,42,59
MD,NI01,0,26,0,26
MD,NI04,0,51,0,51
MD,NI06,0,93,0,93
MD,NI10,0,0,18,18
MD,NI11,0,0,26,26
MD,NI31,0,25,0,25
MD,NR70,0,27,0,27
MD,OA01,0,103,13,116
MD,OA04,0,47,22,69
MD,OA05,0,22,22,44
MD,OA13,0,63,0,63
MD,OA14,0,73,30,103
MD,OA15,0,13,0,13
MD,OA17,0,0,33,33
MD,OA19,0,0,22,22
MD,OA20,0,34,0,34
MD,OA24,0,107,0,107
MD,OA28,0,59,37,96
MD,OR02,0,26,0,26
MD,OR03,0,12,0,12
MD,OV01,0,33,16,49
MD,OV02,0,20,0,20
MD,OV03,0,13,16,29
MD,PE01,0,0,76,76
MD,PE02,0,91,26,117
MD,PE03,0,44,12,56
MD,PE04,0,46,19,65
MD,PE05,0,39,0,39
MD,PE06,0,76,0,76
MD,PE07,0,46,0,46
MD,PE08,0,77,122,199
MD,PE09,0,38,0,38
MD,PE10,0,0,110,110
MD,PE11,0,0,19,19
MD,PE90,0,46,0,46
MD,SC03,0,49,0,49
MD,SC06,0,88,24,112
MD,SC07,0,30,0,30
MD,SC08,0,43,0,43
MD,SC09,0,0,23,23
MD,SC10,0,53,23,76
MD,SC12,0,18,27,45
MD,SC15,0,0,25,25
MD,SC16,0,24,30,54
MD,SC17,0,23,30,53
MD,SC18,0,37,33,70
MD,SC21,0,0,31,31
MD,SC25,0,57,30,87
MD,SC46,0,52,54,106
MD,SC62,0,23,0,23
MD,SC65,0,30,0,30
MD,SC66,0,60,27,87
MD,SC67,0,0,14,14
MD,T006,0,244,235,479
MD,T007,0,588,279,867
MD,T008,0,39,0,39
MD,T009,0,54,14,68
MD,T011,0,461,117,578
MD,T012,0,221,100,321
MD,T014,0,22,28,50
MD,T015,0,19,98,117
MD,T016,0,439,124,563
MD,T017,0,387,225,612
MD,T020,0,133,198,331
MD,T021,0,363,183,546
MD,T022,0,104,78,182
MD,T023,0,42,90,132
MD,T024,0,568,438,1006
MD,T025,0,839,534,1373
MD,T026,0,107,17,124
MD,T028,0,11,0,11
MD,T029,0,1193,719,1912
MD,T030,0,139,84,223
MD,T031,0,48,26,74
MD,T032,0,1278,747,2025
MD,T034,0,1371,786,2157
MD,T035,0,1237,679,1916
MD,T036,0,1765,854,2619
MD,T037,0,578,349,927
MD,T038,0,633,408,1041
MD,T039,0,1068,1014,2082
MD,T040,0,73,34,107
MD,T041,0,880,803,1683
MD,T042,0,202,32,234
MD,T043,0,558,416,974
MD,T044,0,507,325,832
MD,T045,0,442,434,876
MD,T046,0,87,164,251
MD,T047,0,311,225,536
MD,T048,0,112,67,179
MD,T049,0,89,21,110
MD,T050,0,54,29,83
MD,T051,0,118,38,156
MD,T052,0,1230,464,1694
MD,T053,0,567,343,910
MD,T054,0,1009,584,1593
MD,T055,0,0,11,11
MD,T056,0,68,82,150
MD,T057,0,347,167,514
MD,T058,0,381,143,524
MD,T059,0,84,0,84
MD,T060,0,822,882,1704
MD,T061,0,68,26,94
MD,T062,0,56,74,130
MD,T063,0,356,314,670
MD,T064,0,192,37,229
MD,T065,0,115,32,147
MD,T066,0,90,47,137
MD,T067,0,52,56,108
MD,T068,0,579,287,866
MD,T069,0,124,140,264
MD,T070,0,145,135,280
MD,T071,0,109,80,189
MD,T072,0,279,182,461
MD,T073,0,438,118,556
MD,T074,0,58,15,73
MD,T075,0,77,126,203
MD,T076,0,127,121,248
MD,T077,0,44,43,87
MD,T078,0,22,0,22
MD,T079,0,75,71,146
MD,T080,0,97,34,131
MD,T081,0,70,39,109
MD,T082,0,35,11,46
MD,T083,0,59,36,95
MD,T084,0,920,638,1558
MD,T085,0,965,421,1386
MD,T086,0,265,276,541
MD,T087,0,135,77,212
MD,T088,0,61,10,71
MD,T089,0,383,104,487
MD,T090,0,85,0,85
MD,T091,0,33,102,135
MD,T092,0,59,0,59
MD,T094,0,277,62,339
MD,T095,0,1749,918,2667
MD,T096,0,1376,777,2153
MD,T097,0,103,11,114
MD,T098,0,103,45,148
MD,T099,0,0,22,22
MD,T100,0,245,158,403
MD,T102,0,630,421,1051
MD,T104,0,60,73,133
MD,T105,0,172,49,221
MD,T106,0,267,280,547
MD,T107,0,148,77,225
MD,T108,0,127,28,155
MD,T109,0,141,118,259
MD,T110,0,65,138,203
MD,T111,0,181,137,318
MD,T112,0,73,43,116
MD,T113,0,72,145,217
MD,T115,0,0,14,14
MD,T116,0,646,417,1063
MD,T117,0,64,18,82
MD,T120,0,22,22,44
MD,T122,0,53,0,53
MD,T123,0,298,25,323
MD,T124,0,89,73,162
MD,T125,0,144,19,163
MD,T126,0,16,20,36
MD,T127,0,88,49,137
MD,T129,0,568,208,776
MD,T131,0,172,193,365
MD,T132,0,30,33,63
MD,T133,0,371,250,621
MD,T134,0,335,189,524
MD,T135,0,67,17,84
MD,T139,0,0,31,31
MD,T160,0,26,12,38
MD,T161,0,129,53,182
MD,T162,0,15,0,15
MD,T165,0,486,209,695
MD,T167,0,16,29,45
MD,T168,0,98,55,153
MD,T190,0,519,174,693
MD,T191,0,359,173,532
MD,T192,0,93,83,176
MD,T196,0,509,603,1112
MD,T199,0,612,336,948
MD,T224,0,44,0,44
MD,T302,0,0,11,11
MD,T306,0,32,0,32
MD,T329,0,53,0,53
MD,T354,0,13,0,13
MD,T385,0,29,0,29
MD,TTC Wheel Trans,0,25,49,74
MD,T501,0,819,616,1435
MD,T502,0,25,97,122
MD,T504,0,1334,694,2028
MD,T505,0,719,783,1502
MD,T506,0,916,481,1397
MD,T509,0,227,235,462
MD,T510,0,939,663,1602
MD,T511,0,485,309,794
MD,T512,0,825,459,1284
MD,T593,0,10820,8850,19670
MD,T594,0,19324,14252,33576
MD,T596,0,31212,25515,56727
MD,T597,0,2639,1992,4631
MD,T598,0,2079,1701,3780
MD,WA01,0,31,32,63
MD,WA02,0,13,0,13
MD,WA03,0,55,70,125
MD,WA04,0,0,16,16
MD,WA05,0,66,27,93
MD,WA06,0,34,48,82
MD,WA07,0,341,356,697
MD,WA08,0,120,97,217
MD,WA09,0,58,104,162
MD,WA10,0,20,38,58
MD,WA11,0,44,78,122
MD,WA12,0,181,108,289
MD,WA13,0,13,0,13
MD,WA14,0,17,13,30
MD,WA15,0,17,0,17
MD,WA16,0,32,96,128
MD,WA17,0,54,0,54
MD,WA19,0,19,42,61
MD,WA20,0,80,21,101
MD,WA201,0,34,123,157
MD,WA21,0,16,16,32
MD,WA22,0,85,57,142
MD,WA23,0,18,32,50
MD,WA24,0,74,65,139
MD,WA25,0,136,21,157
MD,WA27,0,21,11,32
MD,WA29,0,47,17,64
MD,WA35,0,47,0,47
MD,WA51,0,379,120,499
MD,WA52,0,46,0,46
MD,WA53,0,12,45,57
MD,WA55,0,21,21,42
MD,WA56,0,17,0,17
MD,WA57,0,12,0,12
MD,WA58,0,24,0,24
MD,WA59,0,24,0,24
MD,WA60,0,58,0,58
MD,WA61,0,77,0,77
MD,WA62,0,28,28,56
MD,WA63,0,101,23,124
MD,WA64,0,41,22,63
MD,WA65,0,22,22,44
MD,WA71,0,22,0,22
MD,WA90,0,303,229,532
MD,WA91,0,139,84,223
MD,WE02,0,37,0,37
MD,WE05,0,29,18,47
MD,WE06,0,44,18,62
MD,WE08,0,26,0,26
MD,WE09,0,123,0,123
MD,Canada Coach,0,34,11,45
MD,Island Ferry,0,63,39,102
MD,Grey Hound,0,35,13,48
MD,Via Rail,0,0,21,21
MD,Erindale School,0,37,42,79
MD,Private Bus,0,66,82,148
MD,Y001,0,70,41,111
MD,Y002,0,192,76,268
MD,Y003,0,26,29,55
MD,Y004,0,174,99,273
MD,Y005,0,26,0,26
MD,Y007,0,0,26,26
MD,Y008,0,64,29,93
MD,Y011,0,24,0,24
MD,Y013,0,0,24,24
MD,Y020,0,24,79,103
MD,Y022,0,29,27,56
MD,Y023,0,26,46,72
MD,Y033,0,30,0,30
MD,Y053,0,0,33,33
MD,Y055,0,37,98,135
MD,Y057,0,47,22,69
MD,Y077,0,156,190,346
MD,Y083,0,23,0,23
MD,Y085,0,98,152,250
MD,Y087,0,19,0,19
MD,Y088,0,244,83,327
MD,Y090,0,96,36,132
MD,Y091,0,165,25,190
MD,Y098,0,49,0,49
MD,Y099,0,53,81,134
MD,Y900,0,533,360,893
MD,Y901,0,347,292,639
MD,Y902,0,0,21,21
MD,Y903,0,31,20,51
MD,Y904,0,125,27,152
MD,BA10,0,133,61,194
MD,BA11,0,255,216,471
MD,BA12,0,24,0,24
MD,BA13,0,37,57,94
MD,BA14,0,84,54,138
MD,BA15,0,0,40,40
MD,BA16,0,108,34,142
MD,BA18,0,97,25,122
MD,BA20,0,306,103,409
MD,BA22,0,37,0,37
MD,BA24,0,14,0,14
MD,BA28,0,0,28,28
MD,BA30,0,260,89,349
MD,BA31,0,74,140,214
MD,BA32,0,24,0,24
MD,BA33,0,90,54,144
MD,BA34,0,98,20,118
MD,BA39,0,165,12,177
MD,BA41,0,78,68,146
MD,BA97,0,0,57,57
MD,BR01,0,476,367,843
MD,BR02,0,226,262,488
MD,BR03,0,301,308,609
MD,BR04,0,602,332,934
MD,BR05,0,496,292,788
MD,BR07,0,386,270,656
MD,BR08,0,244,46,290
MD,BR09,0,274,124,398
MD,BR101,0,52,23,75
MD,BR11,0,530,427,957
MD,BR12,0,161,44,205
MD,BR13,0,27,27,54
MD,BR14,0,303,278,581
MD,BR15,0,377,249,626
MD,BR16,0,125,50,175
MD,BR17,0,80,17,97
MD,BR18,0,471,278,749
MD,BR19,0,103,47,150
MD,BR20,0,23,0,23
MD,BR21,0,0,74,74
MD,BR22,0,22,0,22
MD,BR23,0,350,335,685
MD,BR24,0,132,42,174
MD,BR25,0,59,0,59
MD,BR29,0,261,96,357
MD,BR30,0,159,167,326
MD,BR31,0,28,0,28
MD,BR32,0,102,51,153
MD,BR33,0,19,0,19
MD,BR35,0,23,0,23
MD,BR40,0,45,0,45
MD,BR50,0,293,101,394
MD,BR501,0,910,703,1613
MD,BR502,0,532,467,999
MD,BR51,0,98,35,133
MD,BR511,0,0,28,28
MD,BR52,0,459,130,589
MD,BR53,0,114,74,188
MD,BR54,0,68,0,68
MD,BR92,0,24,28,52
MD,BR97,0,120,140,260
MD,BT01,0,129,24,153
MD,BT02,0,107,50,157
MD,BT04,0,235,95,330
MD,BT05,0,107,23,130
MD,BT06,0,64,0,64
MD,BT07,0,66,23,89
MD,BT08,0,133,102,235
MD,BT09,0,219,68,287
MD,BT11,0,0,26,26
MD,BT13,0,64,0,64
MD,BT97,0,19,0,19
MD,BT98,0,59,76,135
MD,BU01,0,166,241,407
MD,BU02,0,186,105,291
MD,BU03,0,203,35,238
MD,BU04,0,222,62,284
MD,BU05,0,54,20,74
MD,BU06,0,74,22,96
MD,BU10,0,570,300,870
MD,BU11,0,34,26,60
MD,BU12,0,139,25,164
MD,BU15,0,129,0,129
MD,BU96,0,25,25,50
MD,BU98,0,68,0,68
MD,CO03,0,11,32,43
MD,CO99,0,46,21,67
MD,D101,0,18,51,69
MD,D102,0,18,24,42
MD,D103,0,44,0,44
MD,D105,0,29,0,29
MD,D107,0,0,29,29
MD,D108,0,29,0,29
MD,D110,0,68,80,148
MD,D111,0,29,56,85
MD,D112,0,57,83,140
MD,D121,0,80,0,80
MD,D122,0,33,0,33
MD,D197,0,73,0,73
MD,D198,0,25,49,74
MD,D218,0,24,24,48
MD,D219,0,105,116,221
MD,D221,0,16,49,65
MD,D222,0,85,79,164
MD,D224,0,79,31,110
MD,D225,0,103,55,158
MD,D226,0,139,22,161
MD,D232,0,22,24,46
MD,D280,0,0,27,27
MD,D292,0,0,30,30
MD,D296,0,0,22,22
MD,D297,0,116,90,206
MD,D302,0,124,96,220
MD,D303,0,85,0,85
MD,D304,0,54,46,100
MD,D305,0,114,131,245
MD,D306,0,158,135,293
MD,D397,0,44,0,44
MD,D398,0,38,26,64
MD,D401,0,736,631,1367
MD,D402,0,238,321,559
MD,D403,0,207,130,337
MD,D405,0,17,0,17
MD,D406,0,80,14,94
MD,D407,0,152,187,339
MD,D408,0,137,104,241
MD,D409,0,120,78,198
MD,D410,0,167,222,389
MD,D411,0,212,147,359
MD,D412,0,170,208,378
MD,D419,0,73,19,92
MD,D420,0,109,213,322
MD,D496,0,83,26,109
MD,D497,0,26,58,84
MD,D501,0,0,47,47
MD,D606,0,16,0,16
MD,D915,0,510,404,914
MD,D916,0,381,395,776
MD,D922,0,26,60,86
MD,D923,0,105,84,189
MD,D950,0,62,23,85
MD,FE99,0,16,47,63
MD,GB12,0,0,35,35
MD,GB15,0,85,46,131
MD,GB16,0,163,188,351
MD,GB19,0,71,28,99
MD,GB20,0,27,33,60
MD,GB21,0,658,670,1328
MD,GB25,0,19,0,19
MD,GB27,0,33,0,33
MD,GB29,0,0,57,57
MD,GB30,0,0,8,8
MD,GB31,0,260,257,517
MD,GB33,0,14,0,14
MD,GB34,0,259,340,599
MD,GB38,0,13,41,54
MD,GB40,0,36,17,53
MD,GB46,0,1213,1220,2433
MD,GB52,0,894,641,1535
MD,GB61,0,28,158,186
MD,GB65,0,324,172,496
MD,GB66,0,44,22,66
MD,GB69,0,0,62,62
MD,GB71,0,288,162,450
MD,GB81,0,56,23,79
MD,GB88,0,63,46,109
MD,GB90,0,19,52,71
MD,GB93,0,186,95,281
MD,GB94,0,737,549,1286
MD,GB95,0,80,44,124
MD,GB96,0,14,64,78
MD,GT01,0,1465,1580,3045
MD,GT02,0,359,359,718
MD,GT03,0,271,486,757
MD,GT05,0,170,155,325
MD,GT06,0,39,83,122
MD,GT07,0,231,279,510
MD,GT09,0,1591,1224,2815
MD,GU01,0,41,47,88
MD,GU03,0,117,49,166
MD,GU04,0,17,46,63
MD,GU07,0,35,19,54
MD,GU08,0,34,14,48
MD,GU09,0,69,0,69
MD,GU10,0,20,14,34
MD,GU22,0,21,19,40
MD,GU23,0,19,21,40
MD,GU24,0,17,17,34
MD,GU31,0,30,0,30
MD,GU32,0,69,268,337
MD,GU33,0,87,29,116
MD,GU34,0,0,22,22
MD,GU35,0,77,55,132
MD,GU37,0,91,0,91
MD,GU38,0,70,0,70
MD,GU40,0,90,0,90
MD,GU41,0,36,52,88
MD,GU42,0,86,0,86
MD,GU43,0,74,29,103
MD,GU44,0,0,58,58
MD,GU45,0,0,30,30
MD,GU50,0,50,0,50
MD,GU51,0,0,58,58
MD,GU52,0,58,12,70
MD,GU54,0,0,43,43
MD,GU55,0,30,0,30
MD,GU58,0,30,0,30
MD,GU61,0,59,0,59
MD,GU70,0,56,131,187
MD,GU71,0,0,28,28
MD,GU76,0,60,0,60
MD,GU97,0,13,71,84
MD,GU99,0,53,156,209
MD,HA01,0,2082,1395,3477
MD,HA02,0,1447,953,2400
MD,HA03,0,360,139,499
MD,HA04,0,506,305,811
MD,HA05,0,1599,1172,2771
MD,HA06,0,155,96,251
MD,HA07,0,144,18,162
MD,HA08,0,161,76,237
MD,HA10,0,865,686,1551
MD,HA11,0,168,290,458
MD,HA12,0,45,0,45
MD,HA16,0,0,56,56
MD,HA21,0,424,505,929
MD,HA22,0,308,299,607
MD,HA23,0,482,266,748
MD,HA24,0,312,227,539
MD,HA25,0,581,154,735
MD,HA26,0,276,131,407
MD,HA27,0,513,371,884
MD,HA33,0,202,53,255
MD,HA34,0,198,149,347
MD,HA35,0,544,436,980
MD,HA41,0,965,656,1621
MD,HA43,0,316,200,516
MD,HA44,0,41,115,156
MD,HA51,0,361,318,679
MD,HA52,0,351,155,506
MD,HA55,0,288,106,394
MD,HA58,0,230,0,230
MD,HA90,0,29,0,29
MD,HA93,0,35,0,35
MD,HA98,0,333,120,453
MD,HA99,0,0,34,34
MD,LI03,0,0,20,20
MD,MI97,0,26,0,26
MD,Midland Transit,0,127,40,167
MD,ML02,0,197,27,224
MD,ML04,0,24,50,74
MD,ML06,0,35,0,35
MD,ML07,0,51,0,51
MD,MS01,0,1425,1071,2496
MD,MS03,0,774,469,1243
MD,MS04,0,189,182,371
MD,MS05,0,321,365,686
MD,MS06,0,255,189,444
MD,MS07,0,231,66,297
MD,MS08,0,361,203,564
MD,MS09,0,162,104,266
MD,MS10,0,413,398,811
MD,MS101,0,142,81,223
MD,MS102,0,21,0,21
MD,MS103,0,205,234,439
MD,MS107,0,0,28,28
MD,MS11,0,218,131,349
MD,MS110,0,460,592,1052
MD,MS12,0,20,0,20
MD,MS13,0,654,454,1108
MD,MS14,0,0,20,20
MD,MS15,0,41,46,87
MD,MS16,0,44,22,66
MD,MS18,0,0,30,30
MD,MS19,0,2541,1580,4121
MD,MS20,0,436,343,779
MD,MS22,0,222,116,338
MD,MS23,0,321,249,570
MD,MS24,0,19,0,19
MD,MS25,0,29,0,29
MD,MS26,0,456,709,1165
MD,MS27,0,24,42,66
MD,MS28,0,396,94,490
MD,MS29,0,236,69,305
MD,MS30,0,61,66,127
MD,MS301,0,19,0,19
MD,MS303,0,22,0,22
MD,MS304,0,0,42,42
MD,MS305,0,0,17,17
MD,MS309,0,21,0,21
MD,MS31,0,50,0,50
MD,MS312,0,50,42,92
MD,MS313,0,22,0,22
MD,MS317,0,33,20,53
MD,MS319,0,38,28,66
MD,MS32,0,27,0,27
MD,MS328,0,20,22,42
MD,MS334,0,43,0,43
MD,MS34,0,305,266,571
MD,MS35,0,437,318,755
MD,MS36,0,166,101,267
MD,MS38,0,518,267,785
MD,MS39,0,136,161,297
MD,MS41,0,95,50,145
MD,MS42,0,214,95,309
MD,MS44,0,416,265,681
MD,MS45,0,215,182,397
MD,MS47,0,42,91,133
MD,MS48,0,221,171,392
MD,MS49,0,70,67,137
MD,MS51,0,207,406,613
MD,MS53,0,106,50,156
MD,MS57,0,54,0,54
MD,MS59,0,34,0,34
MD,MS61,0,445,488,933
MD,MS66,0,542,284,826
MD,MS68,0,81,0,81
MD,MS71,0,0,29,29
MD,MS76,0,28,19,47
MD,MS82,0,23,0,23
MD,MS89,0,91,0,91
MD,MS90,0,57,31,88
MD,MS91,0,17,42,59
MD,MS97,0,0,21,21
MD,MS98,0,132,59,191
MD,MS990,0,101,27,128
MD,NI01,0,156,0,156
MD,NI02,0,0,26,26
MD,NI03,0,26,0,26
MD,NI04,0,67,18,85
MD,NI05,0,0,53,53
MD,NI10,0,76,0,76
MD,NI11,0,26,51,77
MD,NI12,0,0,33,33
MD,NI14,0,64,25,89
MD,NI15,0,26,0,26
MD,NI30,0,25,0,25
MD,NI31,0,126,98,224
MD,NI97,0,20,14,34
MD,NI98,0,25,0,25
MD,NR70,0,0,31,31
MD,OA01,0,263,155,418
MD,OA02,0,0,75,75
MD,OA03,0,125,0,125
MD,OA04,0,28,44,72
MD,OA06,0,37,49,86
MD,OA10,0,18,0,18
MD,OA13,0,20,0,20
MD,OA14,0,391,105,496
MD,OA15,0,70,0,70
MD,OA17,0,63,67,130
MD,OA19,0,88,144,232
MD,OA20,0,14,0,14
MD,OA21,0,22,66,88
MD,OA22,0,37,0,37
MD,OA24,0,187,33,220
MD,OA28,0,19,122,141
MD,OA32,0,13,0,13
MD,OA97,0,64,0,64
MD,OR01,0,12,0,12
MD,OR02,0,76,0,76
MD,OR03,0,26,29,55
MD,OR04,0,62,10,72
MD,OR05,0,102,99,201
MD,OV01,0,50,16,66
MD,OV02,0,92,16,108
MD,OV03,0,40,16,56
MD,Port Colborne Transit,0,0,29,29
MD,PE01,0,141,26,167
MD,PE02,0,72,66,138
MD,PE03,0,65,36,101
MD,PE04,0,106,199,305
MD,PE05,0,46,224,270
MD,PE06,0,248,63,311
MD,PE07,0,114,46,160
MD,PE08,0,146,23,169
MD,PE09,0,77,46,123
MD,PE10,0,97,12,109
MD,PE11,0,137,19,156
MD,PE90,0,280,46,326
MD,PE98,0,13,0,13
MD,Rockwood Transit,0,30,0,30
MD,SC01,0,15,30,45
MD,SC02,0,95,23,118
MD,SC03,0,89,0,89
MD,SC04,0,229,12,241
MD,SC05,0,111,19,130
MD,SC06,28,71,109,208
MD,SC07,0,45,127,172
MD,SC08,0,90,24,114
MD,SC09,0,40,31,71
MD,SC10,0,144,27,171
MD,SC11,0,55,67,122
MD,SC12,0,45,0,45
MD,SC14,0,61,0,61
MD,SC15,0,54,0,54
MD,SC16,0,201,119,320
MD,SC17,0,136,84,220
MD,SC18,0,145,41,186
MD,SC20,0,83,33,116
MD,SC25,0,60,58,118
MD,SC46,0,87,0,87
MD,SC51,0,19,0,19
MD,SC56,0,51,12,63
MD,SC59,0,19,12,31
MD,SC60,0,55,0,55
MD,SC67,0,0,15,15
MD,SC72,0,28,63,91
MD,SC98,0,61,0,61
MD,T005,0,316,148,464
MD,T006,0,757,451,1208
MD,T007,0,2334,695,3029
MD,T008,0,175,266,441
MD,T009,0,304,377,681
MD,T011,0,1015,394,1409
MD,T012,0,473,717,1190
MD,T014,0,187,50,237
MD,T015,0,187,47,234
MD,T016,0,929,648,1577
MD,T017,0,817,489,1306
MD,T020,0,462,203,665
MD,T021,0,724,465,1189
MD,T022,0,567,420,987
MD,T023,0,267,202,469
MD,T024,0,2431,1711,4142
MD,T025,0,2843,2258,5101
MD,T026,0,288,132,420
MD,T028,0,113,62,175
MD,T029,0,3351,1962,5313
MD,T030,0,254,81,335
MD,T031,0,216,78,294
MD,T032,0,3202,2139,5341
MD,T033,0,32,17,49
MD,T034,0,2123,1423,3546
MD,T035,0,3821,1651,5472
MD,T036,0,2574,1853,4427
MD,T037,0,1350,700,2050
MD,T038,0,994,242,1236
MD,T039,0,2275,2061,4336
MD,T040,0,341,296,637
MD,T041,0,1845,1064,2909
MD,T042,0,410,436,846
MD,T043,0,1298,693,1991
MD,T044,0,538,418,956
MD,T045,0,1564,1127,2691
MD,T046,0,468,326,794
MD,T047,0,825,598,1423
MD,T048,0,284,168,452
MD,T049,0,251,208,459
MD,T050,0,222,233,455
MD,T051,0,260,108,368
MD,T052,0,2640,1074,3714
MD,T053,0,1406,1318,2724
MD,T054,0,2846,1633,4479
MD,T055,0,197,67,264
MD,T056,0,164,123,287
MD,T057,0,1008,731,1739
MD,T058,0,678,411,1089
MD,T059,0,63,257,320
MD,T060,0,1700,952,2652
MD,T061,0,292,310,602
MD,T062,0,153,295,448
MD,T063,0,1007,773,1780
MD,T064,0,614,250,864
MD,T065,0,345,64,409
MD,T066,0,495,246,741
MD,T067,0,662,197,859
MD,T068,0,1090,707,1797
MD,T069,0,403,234,637
MD,T070,0,534,467,1001
MD,T071,0,304,184,488
MD,T072,0,464,383,847
MD,T073,0,781,421,1202
MD,T074,0,80,91,171
MD,T075,0,437,323,760
MD,T076,0,638,422,1060
MD,T077,0,268,65,333
MD,T078,0,137,32,169
MD,T079,0,850,511,1361
MD,T080,0,207,73,280
MD,T081,0,565,379,944
MD,T082,0,87,37,124
MD,T083,0,205,0,205
MD,T084,0,1240,787,2027
MD,T085,0,2131,1386,3517
MD,T086,0,1525,744,2269
MD,T087,0,420,376,796
MD,T088,0,304,98,402
MD,T089,0,1246,474,1720
MD,T090,0,367,228,595
MD,T091,0,293,248,541
MD,T092,0,101,201,302
MD,T094,0,874,414,1288
MD,T095,0,2690,1407,4097
MD,T096,0,2263,1217,3480
MD,T097,0,249,144,393
MD,T098,0,287,115,402
MD,T100,0,1241,924,2165
MD,T102,0,1828,1275,3103
MD,T103,0,38,11,49
MD,T104,0,232,70,302
MD,T105,0,601,274,875
MD,T106,0,555,339,894
MD,T107,0,391,132,523
MD,T108,0,427,394,821
MD,T109,0,605,173,778
MD,T110,0,428,331,759
MD,T111,0,412,281,693
MD,T112,0,1008,505,1513
MD,T113,0,400,357,757
MD,T115,0,43,14,57
MD,T116,0,1877,1089,2966
MD,T117,0,35,77,112
MD,T120,0,114,49,163
MD,T122,0,326,175,501
MD,T123,0,449,202,651
MD,T124,0,232,96,328
MD,T125,0,417,201,618
MD,T126,0,249,18,267
MD,T127,0,197,115,312
MD,T129,0,1416,676,2092
MD,T130,0,237,144,381
MD,T131,0,590,293,883
MD,T132,0,133,283,416
MD,T133,0,1222,550,1772
MD,T134,0,629,408,1037
MD,T135,0,148,103,251
MD,T139,0,166,146,312
MD,T141,0,15,0,15
MD,T144,0,16,0,16
MD,T160,0,231,87,318
MD,T161,0,267,73,340
MD,T162,0,61,0,61
MD,T165,0,854,375,1229
MD,T167,0,36,84,120
MD,T168,0,599,357,956
MD,T169,0,105,84,189
MD,T190,0,602,281,883
MD,T191,0,619,499,1118
MD,T192,0,135,101,236
MD,T196,0,1115,1433,2548
MD,T199,0,792,483,1275
MD,T224,0,173,92,265
MD,T300,0,17,0,17
MD,T302,0,14,11,25
MD,T303,0,0,14,14
MD,T316,0,32,0,32
MD,T354,0,13,0,13
MD,T400,0,0,15,15
MD,T402,0,13,0,13
MD,T404,0,14,0,14
MD,T405,0,51,0,51
MD,TTC Wheel Trans,0,3056,1704,4760
MD,T501,0,3944,3718,7662
MD,T502,0,174,93,267
MD,T503,0,39,16,55
MD,T504,0,4474,3133,7607
MD,T505,0,2734,2005,4739
MD,T506,0,3682,2641,6323
MD,T508,0,52,164,216
MD,T509,0,1007,708,1715
MD,T510,0,1251,1029,2280
MD,T511,0,1398,888,2286
MD,T512,0,2046,1393,3439
MD,T593,0,9997,8468,18465
MD,T594,0,22450,18303,40753
MD,T596,0,20728,15567,36295
MD,T597,0,1138,618,1756
MD,T598,0,1841,1164,3005
MD,WA01,0,240,125,365
MD,WA02,0,80,32,112
MD,WA03,0,100,121,221
MD,WA04,0,96,102,198
MD,WA05,0,148,203,351
MD,WA06,0,154,20,174
MD,WA07,0,1753,1108,2861
MD,WA08,0,554,655,1209
MD,WA09,0,289,348,637
MD,WA10,0,259,151,410
MD,WA11,0,188,149,337
MD,WA12,0,556,555,1111
MD,WA13,0,256,206,462
MD,WA14,0,20,0,20
MD,WA15,0,169,0,169
MD,WA16,0,74,140,214
MD,WA17,0,67,38,105
MD,WA18,0,31,20,51
MD,WA19,0,0,43,43
MD,WA20,0,58,64,122
MD,WA201,0,749,352,1101
MD,WA21,0,16,29,45
MD,WA22,0,204,144,348
MD,WA23,0,40,50,90
MD,WA24,0,172,54,226
MD,WA25,0,182,93,275
MD,WA27,0,50,166,216
MD,WA29,0,237,287,524
MD,WA31,0,0,92,92
MD,WA33,0,0,34,34
MD,WA35,0,80,91,171
MD,WA51,0,432,73,505
MD,WA52,0,200,262,462
MD,WA53,0,34,45,79
MD,WA54,0,54,23,77
MD,WA55,0,84,43,127
MD,WA56,0,36,0,36
MD,WA57,0,37,12,49
MD,WA58,0,84,0,84
MD,WA59,0,41,64,105
MD,WA60,0,80,79,159
MD,WA61,0,105,28,133
MD,WA62,0,28,55,83
MD,WA63,0,167,17,184
MD,WA64,0,91,0,91
MD,WA65,0,50,60,110
MD,WA66,0,0,66,66
MD,WA67,0,54,30,84
MD,WA71,0,84,50,134
MD,WA73,0,0,82,82
MD,WA75,0,37,0,37
MD,WA90,0,899,445,1344
MD,WA91,0,125,296,421
MD,WA97,0,81,100,181
MD,WA98,0,164,206,370
MD,WA99,0,45,32,77
MD,WE01,0,42,0,42
MD,WE02,0,18,18,36
MD,WE03,0,46,0,46
MD,WE04,0,17,0,17
MD,WE05,0,126,44,170
MD,WE06,0,209,37,246
MD,WE08,0,75,79,154
MD,WE09,0,101,111,212
MD,WE51,0,28,28,56
MD,WE98,0,77,110,187
MD,Charter Bus,0,29,10,39
MD,Canada Coach,0,0,16,16
MD,XF98,0,103,76,179
MD,Island Ferry,0,185,324,509
MD,Grey Hound,0,276,162,438
MD,Via Rail,0,175,130,305
MD,Erindale School,0,0,28,28
MD,Private Bus,0,2853,1682,4535
MD,Y001,0,120,32,152
MD,Y002,0,239,159,398
MD,Y003,0,239,99,338
MD,Y004,0,546,150,696
MD,Y005,0,358,133,491
MD,Y007,0,212,130,342
MD,Y008,0,68,42,110
MD,Y009,0,0,20,20
MD,Y010,0,202,173,375
MD,Y012,0,46,24,70
MD,Y013,0,26,41,67
MD,Y018,0,46,77,123
MD,Y020,0,210,205,415
MD,Y022,0,123,60,183
MD,Y023,0,156,26,182
MD,Y031,0,22,18,40
MD,Y032,0,22,45,67
MD,Y033,0,0,30,30
MD,Y040,0,16,16,32
MD,Y041,0,38,76,114
MD,Y044,0,52,19,71
MD,Y050,0,34,69,103
MD,Y051,0,34,0,34
MD,Y054,0,58,17,75
MD,Y055,0,243,134,377
MD,Y056,0,22,49,71
MD,Y057,0,178,99,277
MD,Y058,0,33,0,33
MD,Y077,0,183,220,403
MD,Y081,0,0,19,19
MD,Y082,0,31,70,101
MD,Y083,0,64,65,129
MD,Y084,0,49,19,68
MD,Y085,0,436,420,856
MD,Y086,0,69,123,192
MD,Y087,0,134,47,181
MD,Y088,0,493,227,720
MD,Y090,0,220,302,522
MD,Y091,0,438,371,809
MD,Y098,0,135,59,194
MD,Y099,0,342,88,430
MD,Y300,0,34,32,66
MD,Y301,0,21,0,21
MD,Y360,0,27,0,27
MD,Y400,0,46,0,46
MD,Y410,0,0,21,21
MD,Y411,0,20,0,20
MD,Y440,0,0,21,21
MD,Y443,0,22,0,22
MD,Y444,0,0,23,23
MD,Y445,0,22,0,22
MD,Y446,0,40,0,40
MD,Y461,0,20,0,20
MD,Y463,0,20,0,20
MD,Y464,0,0,22,22
MD,Y520,0,47,13,60
MD,Y521,0,47,47,94
MD,Y522,0,0,32,32
MD,Y589,0,78,16,94
MD,Y600,0,204,100,304
MD,Y760,0,0,20,20
MD,Y900,0,1691,1512,3203
MD,Y901,0,573,557,1130
MD,Y902,0,77,45,122
MD,Y904,0,145,72,217
MD,Y999,0,28,0,28
MD,Handi-Transit / Wheel Trans,0,396,105,501
